53,2,16,4,15,4,28,5,56,4,56,4,25,2,18,3,12,3,65,3,65,5,35,4,4,5,37,4,65,2,40,1,25,1,32,5,32,3,39,5,39,2,32,3,39,4,39,2,32,3,10,1,23,5,41,2,13,2,57,0,45,1,31,3,13,0,51,5,51,0,51,0,52,5,34,4,34,1,8,2,67,2,60,1,22,5,11,3,40,5,40,4,12,5,40,1,40,1,25,0,38,1,12,3,65,5,65,3,65,3,35,3,49,3,35,2,25,3,39,3,39,3,39,2,32,4,3,0,2,2,63,0,36,3,26,1,33,2,21,3,3,3,10,1,23,4,23,4,23,1,23,1,46,3,19,1,29,5,47,2,66,0,48,5,69,2,24,1,42,5,62,5,6,4,6,4,11,3,40,4,40,1,25,4,0,3,37,5,65,5,65,3,35,5,39,2,32,5,32,3,39,3,39,3,39,3,39,3,39,1,58,1,23,3,10,3,10,1,23,1,23,3,10,1,23,4,23,3,19,1,46,4,29,5,47,2,68,0,14,0,14,5,34,2,24,1,42,5,6,4,6,3,12,3,65,4,65,3,35,3,4,3,37,3,65,2,40,3,35,3,39,5,39,3,10,1,23,3,10,1,23,5,41,1,41,4,41,5,41,5,41,1,41,5,41,1,41,0,17,0,17,0,17,2,13,2,9,3,68,0,14,5,34,2,24,1,42,0,27,1,22,2,60,0,43,1,5,1,5,4,5,5,6,1,6,1,11,4,11,4,11,4,6,3,32,4,32,3,10,4,19,4,19,5,19,1,46,5,30,5,30,5,30,4,30,1,30,4,30,0,44,0,44,0,44,2,7,3,44,2,7,0,14,5,34,2,24,1,42,0,27,4,27,1,5,4,5,4,5,5,11,5,6,3,0,4,12,3,65,4,65,3,35,1,20,5,70,5,70,5,70,5,70,5,41,5,30,0,44,5,44,1,30,5,30,2,7,2,9,3,7,0,50,0,50,0,50,0,50,0,50,0,50,5,48,5,69,2,61,2,61,1,42,5,6,5,6,4,11,3,40,1,40,1,25,2,18,3,12,4,40,4,40,4,25,0,32,5,32,5,3,0,59,4,59,0,59,3,1,3,1,1,3,3,10,0,10,1,23,1,46,1,46,4,46,5,30,0,44,2,7,0,50,5,48,5,69,2,61,0,54,1,22,1,22,5,11,4,11,4,11,1,6,1,6,1,11,1,11,5,11,1,6,5,55,5,55,5,55,5,55,3,3,1,3,5,3,0,59,1,3,3,10,1,23,2,3,3,10,1,46,5,41,1,41,4,41,2,7,0,50,5,14,5,69,2,61,4,24,1,22,5,6,3,12,1,40,3,65,3,35,3,4,5,37,4,65,5,65,3,35,3,39,5,10,3,10,4,10,1,46,4,46,4,46,2,33,4,33,3,19,2,33,3,19,2,33,3,19,1,46,5,30,5,30,5,30,2,7,0,48,5,69,2,24,0,54,2,24,0,27,1,22,5,6,1,11,3,40,4,40,3,35,3,4,4,37,4,65,4,65,3,35,1,58,5,41,5,41,5,41,5,41,4,30,4,41,4,41,3,17,1,30,4,30,5,30,2,7,0,50,1,7,3,44,0,44,2,7,0,50,5,14,5,34,2,24,4,24,1,22,5,6,1,11,4,11,1,11,5,6,1,6,3,12,4,40,5,40,1,25,5,32,4,3,5,3,5,3,4,3,3,19,0,19,2,33,5,33,3,19,1,46,4,46,2,33,5,33,3,19,3,19,0,19,5,19,5,19,2,64
53,4,53,4,84,2,15,3,78,3,88,2,56,1,25,1,0,1,12,5,40,4,40,5,25,2,18,3,12,4,40,5,40,3,35,0,160,3,76,3,76,1,23,4,23,1,23,5,30,5,30,0,44,0,44,0,44,0,44,0,44,0,44,0,44,2,79,0,75,0,75,0,75,0,48,5,69,2,138,0,140,4,140,1,42,5,62,1,62,4,6,3,0,4,12,3,142,2,40,1,40,4,25,3,82,4,142,3,130,4,130,5,80,1,111,5,111,2,93,5,81,1,81,5,92,3,153,1,162,5,112,2,154,0,74,0,74,0,74,0,74,0,74,0,74,0,74,0,74,0,74,5,116,5,145,2,61,2,24,2,94,1,150,1,150,5,96,4,96,5,96,3,139,3,155,3,71,2,119,3,146,4,146,5,72,2,139,0,139,0,90,3,114,3,114,3,121,5,121,3,153,4,153,1,162,3,153,3,153,0,153,0,153,4,153,1,162,5,112,5,112,4,112,2,154,0,74,0,116,5,145,2,138,1,149,2,110,0,128,0,140,1,113,5,134,1,134,3,151,2,104,4,104,4,157,1,144,1,96,3,122,4,122,5,139,4,156,4,119,3,130,4,130,3,158,2,139,1,159,5,100,5,161,5,93,5,85,4,85,3,131,0,147,5,147,5,118,1,89,2,73,3,106,0,118,1,89,5,102,5,103,1,103,1,103,1,102,2,115,0,116,5,145,2,61,0,54,0,27,1,150,1,137,5,96,5,96,3,139,2,157,1,96,5,96,4,96,4,144,3,90,5,90,2,124,5,124,4,124,4,136,0,36,5,36,1,123,3,73,3,106,3,106,4,106,1,89,4,89,4,89,5,102,2,154,0,74,5,116,5,145,2,61,2,61,1,132,0,27,2,94,1,137,5,96,1,96,1,144,3,156,3,142,3,130,5,86,3,164,2,135,4,148,1,117,5,117,5,117,5,117,5,117,5,117,5,117,5,117,2,133,1,99,3,120,1,83,5,83,4,83,1,83,5,83,5,83,5,108,1,108,5,108,5,108,5,108,5,108,5,108,5,108,5,108,5,108,1,108,5,108,5,108,5,108,5,108,5,108,0,163,1,108,5,108,5,108,5,108,5,108,5,143,5,143,5,143,0,125,5,125,1,143,0,163,5,163,1,108,5,108,4,108,5,108,4,143,3,127,3,127,3,127,1,143,5,108,5,108,5,108,5,108,5,108,3,97,1,107,5,107,5,107,5,107,5,107,5,107,5,107,0,91,0,91,5,95,2,109,2,141,2,126,1,98,3,152,1,108,5,108,5,108,4,143,5,143,2,101,3,87,1,129,5,108,5,108,3,77,2,127,3,127,3,77,5,77,2,152,1,108,5,108,5,108,5,108,5,108,0,163,1,108,5,143,0,125,1,108,5,108,5,108,3,77,5,77,5,77,5,77,2,152,0,163,1,108,5,108,5,108,5,108,5,108,2,105,3,152,1,108,5,108,5,108,0,163,1,108,5,108,5,108,5,108,5,108,5,108,5,108,4,108,1,108,5,108,5,108,5,108,4,108,5,108,5,108,5,108,5,108,0,163,1,108,5,108,0,163,1,108,5,108,5,108,5,108,5,108,5,108,5,108,5,108,5,108,5,108,1,108,5,108,5,108,5,143,5,143,5,143,5,143,3,127,1,143,5,108,3,77,2,152,5,152,1,108,5,108,5,108,5,108,5,143,5,143,5,108,5,108,5,108,0,163,5,163,5,163,1,143,5,143,0,125,1,143,5,143,3,127,3,127,0,125,4,163,5,125,1,143
53,2,16,3,84,2,28,2,166,4,166,4,18,4,18,1,11,3,40,1,40,1,25,5,0,4,12,1,40,1,40,5,25,5,32,5,32,4,32,5,3,5,3,5,3,5,3,3,10,1,23,4,46,4,46,0,19,4,19,5,19,5,19,1,46,5,30,2,7,0,50,0,52,5,210,2,24,1,42,2,67,0,27,1,22,1,5,2,203,0,43,0,27,1,22,5,6,1,11,3,40,1,40,1,25,5,32,3,39,3,39,3,10,3,19,3,19,1,46,0,19,4,19,1,46,5,30,1,30,4,30,5,30,0,44,2,7,0,50,0,50,1,7,0,14,0,14,5,34,2,24,1,42,2,60,1,22,1,5,5,11,5,11,3,25,3,4,2,12,1,40,1,40,5,25,2,174,3,3,5,3,3,19,1,46,5,30,2,7,0,50,0,50,4,50,1,7,5,183,1,183,3,19,2,189,1,183,3,19,1,46,5,30,2,204,0,171,5,177,2,24,1,42,0,27,1,22,5,11,3,182,1,198,5,170,2,196,3,207,4,178,3,211,5,20,2,32,3,23,0,175,1,23,5,41,5,41,3,41,1,30,2,7,3,30,0,179,0,179,0,179,0,179,0,179,0,179,2,7,0,50,0,50,0,48,5,69,2,61,0,54,0,27,1,22,2,203,2,203,4,203,0,27,2,94,1,5,5,11,4,11,5,6,1,55,0,169,1,55,4,55,5,55,5,55,5,55,4,55,5,167,3,33,2,21,3,33,3,46,3,46,1,46,5,30,2,7,0,50,5,50,5,48,5,69,2,61,2,24,1,22,1,22,1,5,5,11,3,40,3,20,2,0,5,12,3,176,4,176,3,20,1,58,5,70,5,70,5,70,5,41,5,41,5,41,5,41,5,30,5,30,0,179,0,179,0,179,0,179,0,179,0,179,4,179,0,179,2,79,0,48,5,69,2,61,0,54,1,22,1,22,5,6,3,12,2,191,5,191,1,6,5,6,3,0,4,12,5,40,4,40,3,20,0,76,0,76,0,76,0,76,3,76,3,76,3,76,1,58,5,41,2,7,3,30,0,179,4,179,2,7,0,50,0,50,0,50,0,50,0,75,0,48,5,69,2,61,4,24,0,27,1,22,5,6,3,12,3,176,4,176,4,20,3,165,4,205,3,176,5,211,2,170,0,192,5,192,2,57,2,57,0,45,5,180,1,199,5,199,3,3,3,10,1,46,4,46,5,41,1,41,5,41,3,17,3,17,2,7,0,212,0,197,0,197,5,184,2,185,0,190,1,201,5,206,4,194,1,194,1,194,3,25,1,0,4,12,5,12,3,65,5,65,2,25,0,32,5,3,3,10,0,10,5,10,3,10,5,10,1,23,5,41,5,30,4,30,0,44,1,30,5,30,0,44,0,44,2,7,0,212,0,187,0,197,5,208,2,209,2,209,1,201,0,195,2,200,1,173,5,194,1,194,5,194,3,40,2,202,4,181,1,206,3,12,3,37,3,65,4,65,4,35,2,32,5,32,3,39,3,10,5,19,0,19,2,33,2,168,1,193,1,193,3,33,3,19,3,19,3,19,0,19,1,46,1,46,5,30,2,7,0,197,5,184,2,185,1,172,2,188,1,201,1,201,5,194,1,194,4,194,4,206,5,206,1,194,3,40,3,65,3,35,5,39,1,23,5,41,3,17,1,41,0,44,4,44,2,7,4,7,0,212,0,212,0,212,5,212,0,212,0,212,0,212,0,212,1,7,0,187,0,197,5,184,2,185,2,209,2,186,1,201,5,206,3,12,3,37,4,65
53,2,16,4,15,4,28,5,56,4,56,2,18,4,18,1,11,3,40,5,40,4,25,2,18,4,191,3,40,1,40,3,35,5,39,3,39,2,32,3,39,3,39,3,10,3,10,1,46,5,30,2,7,0,50,5,50,0,50,0,50,0,50,0,50,0,50,0,50,0,75,5,48,5,213,4,213,2,61,1,42,5,6,3,0,3,37,4,65,3,65,4,65,5,65,4,35,2,0,4,12,1,40,1,40,1,25,5,32,2,174,3,3,1,33,5,33,2,21,3,33,0,2,1,33,0,2,0,2,1,33,3,19,1,46,5,30,5,30,5,30,2,7,0,50,0,48,5,69,4,213,2,24,0,27,1,22,5,6,3,12,1,40,5,40,4,25,1,0,4,12,3,65,2,40,1,25,5,25,0,32,5,32,4,32,2,174,5,174,0,169,0,169,3,1,1,33,3,19,1,46,5,30,0,44,0,44,0,44,0,44,2,7,2,9,3,7,0,14,5,34,2,24,2,24,1,22,5,6,1,11,4,11,1,11,5,6,4,6,3,12,4,40,1,40,1,25,4,32,3,39,5,10,3,10,3,10,1,23,5,41,5,41,0,17,3,17,0,17,1,30,5,30,0,44,0,44,0,44,0,44,2,7,0,50,2,221,3,66,0,14,5,69,2,24,1,42,5,62,0,215,1,6,3,25,2,18,1,11,4,11,5,11,4,6,3,0,5,0,4,12,3,65,2,40,1,25,5,32,3,39,2,32,2,174,1,55,3,32,3,39,5,39,5,10,3,19,1,46,4,46,5,30,0,44,0,17,1,41,0,17,2,7,2,9,1,217,0,222,1,217,0,220,3,216,5,216,0,14,5,34,2,24,1,42,5,62,3,56,2,18,4,18,1,11,3,40,1,40,1,25,1,0,4,12,1,40,5,40,5,25,5,32,5,3,4,33,5,33,5,33,4,33,5,33,4,33,5,33,5,33,5,33,3,19,3,19,3,19,1,46,1,46,5,30,5,30,2,7,0,14,5,34,2,24,1,42,0,27,1,22,5,11,1,11,4,11,3,25,3,4,5,37,2,12,5,40,4,40,1,25,5,32,0,59,1,3,2,174,3,3,5,3,3,10,0,19,0,19,4,19,1,46,3,19,1,46,4,46,4,46,1,46,5,30,0,44,2,7,0,14,0,14,5,34,2,24,0,54,1,22,2,60,0,43,1,5,5,11,4,6,3,0,3,37,4,37,4,65,3,65,3,35,2,32,3,39,1,226,5,224,0,225,2,223,4,218,0,219,0,219,0,219,4,219,0,219,2,218,1,41,1,41,5,41,2,13,0,51,0,51,5,14,5,34,4,34,2,24,0,54,0,27,2,94,1,5,5,11,4,11,5,6,1,6,3,12,3,65,5,65,5,35,2,35,4,35,2,25,1,25,3,35,1,20,2,25,1,25,0,32,5,32,3,39,3,39,3,39,3,10,1,23,2,3,0,59,1,3,5,3,3,19,1,23,1,23,4,23,4,23,4,23,5,41,2,13,0,14,5,34,2,24,1,42,5,6,1,6,1,11,5,11,4,11,1,6,4,6,1,11,1,11,5,11,3,25,1,32,3,39,2,32,5,32,0,32,4,32,3,214,3,214,1,58,5,70,5,70,5,70,4,70,4,41,1,41,3,17,1,41,0,44,2,79,0,48,5,69,4,34,2,24,2,24,0,54,1,22,1,22,1,5,5,11,5,11,3,25,3,4,2,12,1,40,5,40,4,25,2,174,1,55,5,55,3,3,1,3,4,3,3,10,1,23,0,10,5,19,0,19
53,4,53,2,15,4,28,2,166,1,62,4,6,3,0,4,12,2,191,3,40,3,35,2,0,4,12,2,191,1,11,5,11,5,6,5,55,5,55,4,55,5,55,2,174,3,3,3,10,1,23,5,41,5,30,0,44,0,44,0,44,4,44,2,7,4,7,0,50,0,50,5,50,0,48,5,69,2,61,0,54,2,94,1,22,1,22,1,22,5,6,4,6,3,12,4,12,3,65,3,65,4,35,4,4,4,37,5,65,4,65,3,35,2,32,2,174,3,32,3,39,1,58,3,39,3,10,1,23,5,41,3,44,2,7,0,50,0,50,0,51,2,227,4,231,3,79,1,7,0,75,5,48,0,48,5,69,2,61,1,42,5,6,5,6,3,12,4,40,5,40,4,25,4,0,2,191,1,11,5,11,1,6,1,55,4,55,3,3,2,174,4,174,3,3,4,33,0,2,1,33,0,59,3,1,1,3,3,10,1,23,1,23,3,10,1,23,5,30,2,7,0,14,2,228,1,217,3,68,0,14,5,34,2,24,2,24,1,42,0,27,2,94,1,22,1,5,5,11,4,11,4,6,1,6,3,12,2,191,4,191,3,40,3,35,5,35,5,39,2,3,3,19,0,19,2,33,5,33,3,19,4,19,1,46,5,30,5,30,5,30,4,30,5,30,4,30,1,30,5,30,0,44,2,7,0,14,5,69,2,61,2,24,1,42,0,27,1,22,1,22,5,11,3,40,5,40,1,25,3,4,4,37,2,40,4,40,1,25,1,32,5,32,5,32,5,32,5,32,4,32,3,39,3,10,3,10,1,23,4,23,4,23,3,10,1,23,4,23,5,41,5,41,0,44,2,7,0,14,5,34,2,24,0,54,0,27,3,229,2,230,1,5,5,11,4,6,3,0,3,37,4,65,3,65,5,35,5,35,1,58,5,70,4,41,5,41,5,41,4,41,5,41,5,41,3,17,1,41,1,41,4,41,5,41,2,13,0,51,0,51,0,51,0,50,0,50,5,14,5,34,2,24,0,54,2,94,2,94,1,5,5,11,4,11,4,6,4,6,1,11,3,40,3,65,4,35,2,32,4,32,5,32,4,32,4,32,5,32,4,32,5,32,0,32,3,39,5,39,3,39,4,39,1,23,4,23,1,23,4,23,5,41,2,7,0,48,0,48,5,69,2,61,1,42,0,27,1,22,0,43,1,5,5,11,4,6,4,6,3,12,3,65,5,65,3,35,3,35,3,35,5,39,3,39,3,39,3,39,5,10,1,23,3,10,1,23,4,23,3,19,1,46,5,30,1,30,4,30,0,44,4,44,2,7,0,50,0,50,5,14,5,34,2,24,2,24,1,22,0,27,1,5,5,11,4,11,5,11,5,6,1,6,4,11,3,40,5,40,3,35,2,25,1,32,5,32,5,32,3,39,1,58,3,39,5,39,5,39,3,39,2,32,3,39,1,23,4,23,1,46,5,30,1,30,5,30,2,7,0,50,5,48,0,48,5,69,2,61,0,54,4,27,1,22,5,11,3,40,1,40,1,25,4,0,1,12,1,40,5,40,3,35,2,32,3,39,3,39,4,10,5,19,2,33,0,2,2,63,1,167,3,33,3,19,1,46,4,46,0,19,1,46,5,30,2,7,0,50,0,50,0,48,5,69,2,61,1,42,2,60,0,27,1,5,5,11,4,11,5,6,4,6,3,12,4,40,5,40,1,25,1,32,5,32,5,3,3,10,1,23,5,41,4,41,4,30,5,30,5,30,0,44,0,44,0,44,2,7,0,50,0,50,0,50,0,50,5,75,5,48
53,4,53,2,15,2,166,3,56,4,56,2,18,1,6,3,12,3,65,4,65,4,35,2,0,3,37,4,65,5,65,4,65,1,176,4,20,4,58,4,23,3,10,1,23,5,41,0,17,0,44,0,44,1,30,0,17,0,44,0,44,1,30,0,44,0,44,0,44,2,7,0,50,1,79,0,48,5,34,4,34,5,34,2,24,4,24,2,94,1,22,1,22,1,5,4,5,3,232,4,235,2,60,2,203,1,5,5,11,3,25,0,25,0,32,3,39,0,160,2,160,3,76,2,160,1,58,3,10,1,46,5,30,5,30,5,30,5,30,0,17,4,17,1,41,2,7,0,50,5,75,5,48,5,69,2,61,1,42,5,6,4,6,3,0,4,12,4,40,4,40,1,25,4,0,4,12,4,40,1,40,1,25,4,32,5,32,5,32,5,32,3,39,3,39,3,39,3,39,5,39,3,39,3,39,1,58,5,41,5,41,1,41,0,17,1,30,0,44,2,7,0,14,5,34,2,24,0,54,0,27,2,94,1,5,5,11,4,11,1,6,1,6,1,11,1,11,4,11,4,6,4,55,5,55,4,55,2,21,0,36,5,36,4,36,1,167,3,33,1,33,4,33,0,2,5,2,1,33,4,33,3,19,3,19,1,46,5,30,5,47,5,47,2,68,0,48,5,69,4,213,2,24,2,94,1,22,5,6,5,11,4,11,5,11,4,6,1,6,3,12,3,65,5,65,5,35,2,32,3,39,3,39,3,39,5,39,3,10,2,3,3,10,3,10,4,19,3,19,1,46,5,30,5,30,5,30,0,44,0,44,0,44,2,7,0,14,5,34,2,24,1,42,0,27,2,94,2,230,1,5,1,5,5,11,5,6,4,6,3,12,3,65,5,65,4,35,0,76,4,76,2,214,4,214,3,76,1,58,5,70,5,41,4,30,5,30,0,44,0,44,0,44,0,44,0,44,0,44,0,44,0,44,2,7,0,14,0,14,5,34,2,24,2,24,0,27,1,22,4,5,5,11,4,11,4,6,4,6,5,11,1,11,5,11,3,25,2,174,1,55,5,55,3,32,3,39,3,39,4,39,2,32,0,32,1,32,5,32,3,10,1,46,4,46,5,30,5,30,1,30,0,44,2,7,0,14,5,34,2,24,1,42,5,6,5,6,3,12,3,65,2,40,1,40,1,25,4,0,1,12,3,65,2,40,5,25,1,32,5,32,5,32,5,3,5,3,5,3,5,3,5,3,2,174,3,3,3,10,3,10,1,23,3,10,3,10,3,10,1,23,5,41,0,44,0,238,2,68,0,14,5,34,2,24,0,54,2,24,1,22,5,6,3,12,3,65,4,65,3,35,3,4,4,37,4,65,3,65,3,65,5,35,5,35,3,39,3,39,3,39,2,32,5,32,3,39,3,39,4,10,3,10,4,10,1,23,3,10,1,23,1,23,5,41,4,41,5,41,2,7,1,7,0,14,5,34,2,24,0,54,4,27,0,27,2,230,0,43,1,5,5,6,3,0,3,37,4,65,4,65,4,35,2,32,4,32,5,32,3,39,3,39,3,39,3,39,3,39,3,39,1,58,1,58,1,58,3,10,1,23,4,23,5,41,1,41,1,30,0,44,2,68,0,14,5,34,2,24,1,42,2,60,2,60,1,5,5,11,5,11,1,6,3,0,4,12,3,65,3,65,3,35,2,35,3,35,2,32,3,39,3,39,0,160,3,76,5,237,1,111,5,234,5,234,3,233,4,233,5,131,1,240,5,103,0,239,1,103,1,102,0,236,2,7,0,14,5,34,2,24
53,2,16,4,15,4,28,5,56,2,166,4,18,3,0,2,191,1,11,5,11,4,6,1,6,3,12,3,65,3,65,2,40,3,35,2,32,4,32,3,39,1,58,5,70,4,41,0,17,1,41,4,41,4,41,4,41,4,41,0,17,0,17,0,44,0,44,0,44,2,7,0,50,5,14,5,34,2,24,2,24,0,54,1,22,4,22,5,11,5,11,4,11,1,6,1,6,3,12,2,191,4,191,1,6,5,55,5,55,4,55,5,167,3,33,3,19,0,19,4,19,4,19,3,19,1,46,4,46,5,30,5,30,4,30,4,30,5,30,0,44,2,7,0,14,5,34,2,24,2,24,0,27,2,94,1,5,5,11,3,40,5,40,4,25,2,18,1,11,4,11,5,11,1,6,3,32,3,39,3,10,1,23,5,41,5,41,5,41,3,17,1,41,0,17,2,13,0,51,0,51,0,51,0,51,1,13,0,51,0,50,5,75,0,48,5,69,2,61,2,24,1,22,5,6,3,12,4,40,3,65,2,25,1,0,4,12,1,40,4,40,5,25,4,32,5,32,5,3,4,3,5,3,3,10,5,10,3,19,1,46,2,33,3,19,1,46,5,30,0,44,1,30,0,44,0,44,0,44,0,44,2,68,0,14,5,34,2,24,1,42,0,27,3,229,2,230,4,230,0,43,0,27,1,22,1,22,5,11,1,11,3,40,3,35,2,32,5,3,5,33,3,19,3,19,4,19,1,46,1,46,3,19,4,19,5,19,1,46,4,46,5,30,2,7,0,51,0,51,0,51,0,51,2,228,1,242,0,222,3,216,5,216,0,48,5,69,2,61,1,241,2,67,0,27,1,22,5,6,3,12,3,65,3,65,3,35,2,0,3,37,2,12,1,40,5,40,5,25,4,25,0,32,3,39,4,39,1,58,5,41,5,30,3,44,0,44,0,44,0,44,1,30,5,30,0,44,0,44,0,44,0,44,2,7,0,50,5,50,0,48,5,69,2,61,2,24,1,22,0,27,1,5,1,5,5,11,4,6,1,6,3,12,4,40,3,65,5,35,2,32,1,32,5,3,4,3,5,3,5,33,5,33,5,33,5,33,4,33,5,33,0,2,1,33,3,19,1,46,5,30,2,7,0,50,0,50,5,48,5,69,2,61,2,24,1,22,4,22,5,11,3,40,5,40,4,25,2,18,1,11,4,11,1,11,5,6,4,6,4,55,4,55,3,3,1,33,3,19,3,19,1,46,2,33,3,19,1,46,4,46,5,30,0,44,0,44,0,44,0,44,0,44,0,44,2,7,0,14,5,34,2,24,1,42,5,6,4,6,1,11,4,11,5,11,4,6,1,6,1,11,4,11,1,11,5,6,1,55,5,55,5,55,5,55,4,55,1,55,0,169,1,55,3,3,1,33,5,33,0,2,3,26,1,33,4,33,3,19,2,33,3,19,2,33,1,64,1,64,5,64,3,243,2,64,1,64,3,243,1,29,5,47,0,244,2,68,0,14,5,34,2,24,2,24,1,22,0,27,3,229,2,230,1,5,4,5,5,6,4,6,1,11,1,11,3,40,1,25,2,174,3,3,0,2,1,33,5,33,4,33,3,19,4,19,1,46,5,30,5,30,1,30,4,30,0,44,2,7,4,7,0,50,0,50,0,50,5,14,5,34,2,24,1,42,0,27,0,27,1,22,1,5,1,5,4,5,0,27,1,22,5,11,3,40,1,40,5,25,2,174,5,174,3,3,3,10,2,33,5,33,5,33,0,2,0,2,0,2,0,2,1,33,3,19,1,46,5,30,5,30
53,3,53,2,15,4,28,5,56,3,88,4,35,4,4,4,4,4,37,2,40,3,65,4,35,2,0,4,12,3,65,4,65,3,35,3,39,3,10,0,10,4,10,1,23,5,41,4,41,0,17,0,17,0,17,0,17,0,44,0,44,0,44,0,44,2,7,0,51,0,51,0,50,5,14,5,69,4,69,2,61,0,54,1,22,5,6,3,12,1,40,4,40,4,25,3,4,3,37,2,12,5,40,3,65,5,35,3,39,3,39,3,39,3,39,3,39,4,10,3,10,3,19,4,10,1,23,5,41,1,41,5,41,1,41,1,41,0,17,2,13,0,50,5,50,5,14,5,34,2,24,1,42,1,22,5,6,3,12,3,65,3,65,4,35,2,0,5,12,4,40,1,40,0,25,4,32,3,39,5,10,0,10,1,23,4,23,5,30,1,30,3,44,1,30,3,44,0,44,1,30,1,30,5,30,4,30,0,44,0,44,2,7,0,14,5,34,2,24,1,42,0,27,2,94,1,5,5,11,5,11,1,6,1,6,3,12,4,40,1,40,5,25,0,32,5,3,5,3,3,19,5,19,1,46,5,30,0,44,0,44,0,44,4,44,0,44,0,44,0,44,0,44,0,44,0,44,2,7,0,50,0,48,5,69,2,24,0,54,1,42,1,22,5,6,4,11,1,11,4,11,3,25,4,0,2,191,1,11,1,11,4,6,1,55,5,55,3,3,0,2,5,2,2,63,3,26,1,33,5,33,2,21,3,33,3,19,1,46,5,30,2,7,0,50,0,50,0,50,5,50,5,14,5,69,2,61,1,42,5,6,1,6,4,11,3,40,4,40,1,40,1,25,4,0,4,12,5,40,1,40,1,25,5,32,3,10,3,10,3,19,4,19,0,19,1,46,3,19,3,19,0,19,0,19,1,46,5,30,4,30,2,7,3,44,0,44,0,44,2,79,0,48,5,69,2,61,0,54,0,27,1,22,1,5,5,11,3,40,4,40,4,25,4,0,3,37,4,65,2,40,1,25,5,32,5,32,2,174,1,55,5,55,5,55,5,55,5,55,3,3,1,33,2,21,3,33,3,19,1,46,5,30,5,30,5,30,0,44,2,7,0,14,5,34,2,24,0,54,2,24,1,22,1,22,5,6,4,11,5,11,5,11,4,6,1,6,3,12,2,191,1,11,5,11,4,6,5,55,5,55,3,3,3,19,5,19,2,33,5,33,3,19,1,46,5,30,0,44,0,44,0,44,0,44,0,44,0,44,0,44,0,44,2,7,0,14,0,48,5,69,2,61,0,54,2,94,2,94,1,5,4,5,0,43,0,43,1,22,5,6,3,12,1,40,4,40,3,35,1,58,3,39,3,10,3,10,2,3,2,174,3,3,3,10,5,19,3,19,0,19,3,19,1,46,4,46,5,30,2,7,0,51,0,51,0,50,5,14,5,69,2,61,1,42,2,60,1,22,1,5,4,5,5,11,4,6,5,6,1,11,3,40,5,40,1,25,0,32,2,174,3,32,5,32,3,39,5,39,1,58,4,23,4,23,1,46,5,30,5,30,1,30,0,44,2,7,3,44,2,7,3,44,2,7,0,14,5,34,2,24,4,24,1,22,1,22,5,6,4,6,3,0,4,0,2,191,1,11,4,11,4,6,3,0,2,191,1,11,5,11,1,6,5,55,3,32,3,39,5,39,5,39,1,58,2,32,3,10,0,10,1,23,5,41,0,44,0,44,3,44,1,30,1,30,5,30,2,7,0,50,5,48,5,69,2,61,0,245,2,24,1,22,2,60,1,5,5,11,1,11
53,4,53,2,15,4,28,2,166,1,62,5,6,1,6,1,11,3,40,5,40,1,40,1,25,4,0,3,37,4,65,1,176,5,259,3,270,1,70,5,70,5,70,5,224,5,224,5,224,5,224,5,70,2,13,1,7,2,9,0,45,0,248,1,31,3,13,0,51,5,51,1,13,0,14,5,34,2,24,0,54,1,22,5,6,3,12,3,65,5,65,2,25,4,0,4,12,1,40,3,65,2,25,0,25,0,32,5,32,3,10,1,23,5,41,5,41,5,41,4,30,5,30,5,30,4,30,4,30,3,44,0,44,0,44,0,44,2,7,0,50,5,50,5,14,5,34,2,24,4,24,1,22,5,6,3,12,4,40,5,40,1,25,5,0,5,12,4,40,1,40,3,35,2,25,1,32,5,32,3,39,5,10,2,3,2,21,2,21,2,21,3,33,3,19,3,19,4,19,4,19,0,19,1,46,4,46,1,46,5,30,2,7,0,14,5,69,2,61,2,24,1,22,2,60,2,203,2,203,1,5,0,27,0,27,1,5,1,5,0,43,1,22,5,55,4,55,3,3,1,3,4,3,5,3,3,10,1,23,5,41,0,17,0,44,5,44,0,44,0,44,0,44,0,44,0,44,2,79,0,75,5,48,5,69,0,213,2,24,1,22,0,27,1,5,5,11,5,11,3,25,1,0,4,0,4,12,4,40,1,40,5,25,0,32,3,39,0,76,3,76,5,237,3,237,3,237,4,237,0,237,3,237,3,264,2,257,1,267,2,253,2,254,1,93,4,93,5,85,3,19,4,243,1,29,5,47,2,266,0,14,5,34,2,24,0,54,1,150,5,144,3,119,5,122,1,263,5,100,1,269,5,261,4,249,5,247,5,263,5,100,5,161,5,254,5,161,5,93,2,262,3,93,4,81,5,81,5,81,3,255,1,271,5,271,5,271,5,271,5,271,5,271,4,271,5,271,2,256,3,272,5,274,1,250,5,260,0,246,2,68,0,14,5,34,2,24,1,42,1,22,4,22,1,5,5,11,5,11,3,25,2,18,3,12,3,130,1,277,5,252,2,192,5,192,4,192,2,57,4,57,1,268,1,268,5,268,0,248,0,248,1,268,3,7,0,50,0,50,4,50,4,50,5,50,0,50,1,7,0,14,5,34,2,24,4,24,1,22,2,60,0,43,1,5,2,203,1,22,5,6,3,12,5,40,3,130,2,25,0,32,3,275,3,275,2,3,2,174,3,3,3,131,2,33,1,33,4,33,3,106,1,89,5,102,5,102,5,102,1,102,0,236,0,236,2,79,0,48,5,69,2,61,1,42,2,60,1,22,1,22,5,11,3,40,4,40,1,25,3,82,4,142,4,130,4,130,3,158,4,275,2,32,5,3,0,59,1,3,4,3,5,3,3,106,1,89,1,89,4,89,4,89,5,102,2,7,1,7,4,7,0,50,5,75,0,75,0,48,5,69,2,61,2,24,1,22,2,60,0,43,1,5,5,11,5,11,1,6,1,6,3,12,3,130,2,40,1,25,1,25,5,32,4,32,3,275,3,275,1,251,5,273,2,276,3,219,1,265,3,258,0,239,1,103,1,103,0,239,0,239,0,239,1,103,5,103,2,7,0,14,0,14,5,34,4,34,2,24,0,54,1,22,1,22,5,11,3,40,1,40,5,25,1,0,5,12,1,12,1,12,4,40,1,40,5,25,4,25,0,32,5,32,5,32,0,32,0,32,0,32,2,174,5,174,5,174,5,174,1,167,3,33,1,33,3,106,1,89,4,89,5,102,0,236,2,7,0,14,5,34
53,2,16,4,15,2,166,1,62,4,62,1,6,1,6,1,11,4,11,5,11,5,6,3,0,4,12,3,65,2,40,5,25,2,174,5,174,3,32,2,174,0,169,5,169,1,55,1,55,3,32,3,39,3,10,3,10,1,23,1,23,3,10,1,23,5,41,5,41,0,44,2,66,0,48,0,48,5,69,4,213,2,24,0,27,1,22,5,11,1,11,1,11,5,11,3,25,2,18,3,12,1,40,1,40,3,35,0,160,4,160,2,160,4,160,4,160,3,76,1,23,5,41,2,13,4,13,4,13,5,13,0,51,4,51,0,51,0,51,0,51,0,51,5,50,5,14,5,34,2,24,1,42,0,27,1,22,5,11,4,11,3,40,2,18,3,0,4,12,4,40,1,40,4,25,2,174,3,32,3,39,3,39,1,58,5,41,5,41,5,41,2,13,2,57,0,45,1,31,0,45,0,45,4,45,5,180,1,199,1,193,3,33,3,243,1,29,5,47,2,68,0,282,5,208,2,209,1,172,0,195,0,195,1,173,5,194,5,194,4,206,5,206,3,0,2,202,1,194,1,194,1,206,3,32,0,32,5,32,3,39,5,39,3,39,3,39,3,39,1,23,4,23,3,10,1,23,3,10,1,23,4,23,1,23,4,23,1,46,5,30,2,66,0,197,5,184,2,185,2,209,1,172,0,195,1,201,1,201,1,173,5,194,5,194,3,25,0,281,1,12,4,40,4,40,4,25,5,32,5,32,2,278,5,278,3,3,3,10,3,10,0,19,1,46,5,30,4,30,1,30,4,30,5,30,0,44,0,17,2,7,4,13,0,212,5,197,0,197,5,184,2,185,1,172,0,195,1,201,5,194,3,40,5,40,1,25,1,0,4,0,1,12,1,40,4,40,5,40,3,35,3,39,0,160,4,160,3,76,2,160,2,160,1,58,2,3,3,10,3,10,0,10,1,23,1,46,5,30,4,41,1,41,3,17,1,30,2,79,0,197,5,184,2,185,1,172,0,195,0,195,1,173,5,194,5,194,4,206,1,206,1,194,1,194,4,194,4,206,4,199,5,199,1,199,5,193,5,193,5,193,0,284,5,248,0,279,3,280,0,75,0,75,0,50,0,50,0,50,0,50,0,50,0,50,0,50,5,48,5,69,2,61,2,24,0,27,2,94,1,5,5,11,3,40,5,25,4,0,3,4,2,12,4,40,1,40,3,35,2,32,5,32,5,32,3,39,1,58,5,70,5,70,2,192,0,192,4,192,1,192,0,51,0,51,3,283,1,13,2,57,3,13,0,51,0,51,0,52,5,210,2,24,1,42,0,54,0,27,0,27,1,5,4,5,5,11,4,6,1,6,3,12,3,65,3,65,3,35,3,39,1,58,5,41,5,41,2,13,3,17,0,17,2,13,0,51,0,51,5,51,0,51,0,51,0,51,0,51,1,7,0,50,0,50,5,50,5,14,5,34,2,24,1,42,2,60,1,22,5,6,3,12,4,40,4,40,4,40,1,25,2,18,1,11,1,11,4,11,1,6,3,32,3,214,5,214,2,214,4,214,3,214,1,226,5,224,4,70,4,70,5,41,3,17,0,17,0,17,0,17,2,13,0,51,0,51,5,50,5,48,5,69,2,61,1,42,2,60,1,22,1,5,0,43,4,43,1,22,4,22,5,6,3,12,3,65,3,65,4,35,1,58,3,10,3,19,3,19,5,19,4,19,3,19,4,19,2,33,2,21,0,169,1,55,3,33,1,33,3,19,1,46,5,30,2,7,0,50,5,48,5,69,2,61,0,54,1,42,1,22
