7,2,19,4,35,4,64,5,54,4,54,4,26,2,16,3,63,3,31,3,31,5,27,4,0,5,5,4,31,2,48,1,26,1,12,5,12,3,67,5,67,2,12,3,67,4,67,2,12,3,41,1,25,5,38,2,15,2,45,0,52,1,61,3,15,0,60,5,60,0,60,0,40,5,49,4,49,1,13,2,2,2,44,1,11,5,37,3,48,5,48,4,63,5,48,1,48,1,26,0,62,1,63,3,31,5,31,3,31,3,27,3,28,3,27,2,26,3,67,3,67,3,67,2,12,4,20,0,24,2,58,0,39,3,32,1,69,2,14,3,20,3,41,1,25,4,25,4,25,1,25,1,47,3,50,1,9,5,21,2,34,0,56,5,1,2,53,1,23,5,17,5,46,4,46,4,37,3,48,4,48,1,26,4,43,3,5,5,31,5,31,3,27,5,67,2,12,5,12,3,67,3,67,3,67,3,67,3,67,1,18,1,25,3,41,3,41,1,25,1,25,3,41,1,25,4,25,3,50,1,47,4,9,5,21,2,4,0,29,0,29,5,49,2,53,1,23,5,46,4,46,3,63,3,31,4,31,3,27,3,0,3,5,3,31,2,48,3,27,3,67,5,67,3,41,1,25,3,41,1,25,5,38,1,38,4,38,5,38,5,38,1,38,5,38,1,38,0,55,0,55,0,55,2,15,2,68,3,4,0,29,5,49,2,53,1,23,0,65,1,11,2,44,0,6,1,36,1,36,4,36,5,46,1,46,1,37,4,37,4,37,4,46,3,12,4,12,3,41,4,50,4,50,5,50,1,47,5,66,5,66,5,66,4,66,1,66,4,66,0,8,0,8,0,8,2,3,3,8,2,3,0,29,5,49,2,53,1,23,0,65,4,65,1,36,4,36,4,36,5,37,5,46,3,43,4,63,3,31,4,31,3,27,1,51,5,70,5,70,5,70,5,70,5,38,5,66,0,8,5,8,1,66,5,66,2,3,2,68,3,3,0,30,0,30,0,30,0,30,0,30,0,30,5,56,5,1,2,10,2,10,1,23,5,46,5,46,4,37,3,48,1,48,1,26,2,16,3,63,4,48,4,48,4,26,0,12,5,12,5,20,0,42,4,42,0,42,3,59,3,59,1,20,3,41,0,41,1,25,1,47,1,47,4,47,5,66,0,8,2,3,0,30,5,56,5,1,2,10,0,22,1,11,1,11,5,37,4,37,4,37,1,46,1,46,1,37,1,37,5,37,1,46,5,57,5,57,5,57,5,57,3,20,1,20,5,20,0,42,1,20,3,41,1,25,2,20,3,41,1,47,5,38,1,38,4,38,2,3,0,30,5,29,5,1,2,10,4,53,1,11,5,46,3,63,1,48,3,31,3,27,3,0,5,5,4,31,5,31,3,27,3,67,5,41,3,41,4,41,1,47,4,47,4,47,2,69,4,69,3,50,2,69,3,50,2,69,3,50,1,47,5,66,5,66,5,66,2,3,0,56,5,1,2,53,0,22,2,53,0,65,1,11,5,46,1,37,3,48,4,48,3,27,3,0,4,5,4,31,4,31,3,27,1,18,5,38,5,38,5,38,5,38,4,66,4,38,4,38,3,55,1,66,4,66,5,66,2,3,0,30,1,3,3,8,0,8,2,3,0,30,5,29,5,49,2,53,4,53,1,11,5,46,1,37,4,37,1,37,5,46,1,46,3,63,4,48,5,48,1,26,5,12,4,20,5,20,5,20,4,20,3,50,0,50,2,69,5,69,3,50,1,47,4,47,2,69,5,69,3,50,3,50,0,50,5,50,5,50,2,33
7,4,7,4,156,2,35,3,128,3,71,2,54,1,26,1,43,1,63,5,48,4,48,5,26,2,16,3,63,4,48,5,48,3,27,0,164,3,127,3,127,1,25,4,25,1,25,5,66,5,66,0,8,0,8,0,8,0,8,0,8,0,8,0,8,2,100,0,162,0,162,0,162,0,56,5,1,2,129,0,133,4,133,1,23,5,17,1,17,4,46,3,43,4,63,3,137,2,48,1,48,4,26,3,144,4,137,3,77,4,77,5,146,1,141,5,141,2,152,5,73,1,73,5,150,3,97,1,130,5,125,2,95,0,103,0,103,0,103,0,103,0,103,0,103,0,103,0,103,0,103,5,87,5,151,2,10,2,53,2,90,1,101,1,101,5,89,4,89,5,89,3,154,3,114,3,80,2,99,3,110,4,110,5,149,2,154,0,154,0,132,3,84,3,84,3,145,5,145,3,97,4,97,1,130,3,97,3,97,0,97,0,97,4,97,1,130,5,125,5,125,4,125,2,95,0,103,0,87,5,151,2,129,1,135,2,78,0,115,0,133,1,98,5,76,1,76,3,160,2,102,4,102,4,111,1,121,1,89,3,142,4,142,5,154,4,106,4,99,3,77,4,77,3,85,2,154,1,91,5,139,5,104,5,152,5,159,4,159,3,72,0,123,5,123,5,113,1,109,2,122,3,86,0,113,1,109,5,79,5,94,1,94,1,94,1,79,2,163,0,87,5,151,2,10,0,22,0,65,1,101,1,147,5,89,5,89,3,154,2,111,1,89,5,89,4,89,4,121,3,132,5,132,2,155,5,155,4,155,4,143,0,39,5,39,1,108,3,122,3,86,3,86,4,86,1,109,4,109,4,109,5,79,2,95,0,103,5,87,5,151,2,10,2,10,1,158,0,65,2,90,1,147,5,89,1,89,1,121,3,106,3,137,3,77,5,140,3,88,2,124,4,81,1,92,5,92,5,92,5,92,5,92,5,92,5,92,5,92,2,107,1,138,3,83,1,148,5,148,4,148,1,148,5,148,5,148,5,105,1,105,5,105,5,105,5,105,5,105,5,105,5,105,5,105,5,105,1,105,5,105,5,105,5,105,5,105,5,105,0,136,1,105,5,105,5,105,5,105,5,105,5,74,5,74,5,74,0,117,5,117,1,74,0,136,5,136,1,105,5,105,4,105,5,105,4,74,3,93,3,93,3,93,1,74,5,105,5,105,5,105,5,105,5,105,3,126,1,82,5,82,5,82,5,82,5,82,5,82,5,82,0,75,0,75,5,131,2,96,2,119,2,134,1,153,3,157,1,105,5,105,5,105,4,74,5,74,2,161,3,116,1,120,5,105,5,105,3,112,2,93,3,93,3,112,5,112,2,157,1,105,5,105,5,105,5,105,5,105,0,136,1,105,5,74,0,117,1,105,5,105,5,105,3,112,5,112,5,112,5,112,2,157,0,136,1,105,5,105,5,105,5,105,5,105,2,118,3,157,1,105,5,105,5,105,0,136,1,105,5,105,5,105,5,105,5,105,5,105,5,105,4,105,1,105,5,105,5,105,5,105,4,105,5,105,5,105,5,105,5,105,0,136,1,105,5,105,0,136,1,105,5,105,5,105,5,105,5,105,5,105,5,105,5,105,5,105,5,105,1,105,5,105,5,105,5,74,5,74,5,74,5,74,3,93,1,74,5,105,3,112,2,157,5,157,1,105,5,105,5,105,5,105,5,74,5,74,5,105,5,105,5,105,0,136,5,136,5,136,1,74,5,74,0,117,1,74,5,74,3,93,3,93,0,117,4,136,5,117,1,74
7,2,19,3,156,2,64,2,189,4,189,4,16,4,16,1,37,3,48,1,48,1,26,5,43,4,63,1,48,1,48,5,26,5,12,5,12,4,12,5,20,5,20,5,20,5,20,3,41,1,25,4,47,4,47,0,50,4,50,5,50,5,50,1,47,5,66,2,3,0,30,0,40,5,206,2,53,1,23,2,2,0,65,1,11,1,36,2,174,0,6,0,65,1,11,5,46,1,37,3,48,1,48,1,26,5,12,3,67,3,67,3,41,3,50,3,50,1,47,0,50,4,50,1,47,5,66,1,66,4,66,5,66,0,8,2,3,0,30,0,30,1,3,0,29,0,29,5,49,2,53,1,23,2,44,1,11,1,36,5,37,5,37,3,26,3,0,2,63,1,48,1,48,5,26,2,210,3,20,5,20,3,50,1,47,5,66,2,3,0,30,0,30,4,30,1,3,5,194,1,194,3,50,2,211,1,194,3,50,1,47,5,66,2,170,0,187,5,182,2,53,1,23,0,65,1,11,5,37,3,198,1,184,5,181,2,192,3,172,4,167,3,178,5,51,2,12,3,25,0,180,1,25,5,38,5,38,3,38,1,66,2,3,3,66,0,175,0,175,0,175,0,175,0,175,0,175,2,3,0,30,0,30,0,56,5,1,2,10,0,22,0,65,1,11,2,174,2,174,4,174,0,65,2,90,1,36,5,37,4,37,5,46,1,57,0,203,1,57,4,57,5,57,5,57,5,57,4,57,5,183,3,69,2,14,3,69,3,47,3,47,1,47,5,66,2,3,0,30,5,30,5,56,5,1,2,10,2,53,1,11,1,11,1,36,5,37,3,48,3,51,2,43,5,63,3,199,4,199,3,51,1,18,5,70,5,70,5,70,5,38,5,38,5,38,5,38,5,66,5,66,0,175,0,175,0,175,0,175,0,175,0,175,4,175,0,175,2,100,0,56,5,1,2,10,0,22,1,11,1,11,5,46,3,63,2,179,5,179,1,46,5,46,3,43,4,63,5,48,4,48,3,51,0,127,0,127,0,127,0,127,3,127,3,127,3,127,1,18,5,38,2,3,3,66,0,175,4,175,2,3,0,30,0,30,0,30,0,30,0,162,0,56,5,1,2,10,4,53,0,65,1,11,5,46,3,63,3,199,4,199,4,51,3,176,4,177,3,199,5,178,2,181,0,169,5,169,2,45,2,45,0,52,5,193,1,202,5,202,3,20,3,41,1,47,4,47,5,38,1,38,5,38,3,55,3,55,2,3,0,188,0,204,0,204,5,190,2,166,0,171,1,185,5,165,4,200,1,200,1,200,3,26,1,43,4,63,5,63,3,31,5,31,2,26,0,12,5,20,3,41,0,41,5,41,3,41,5,41,1,25,5,38,5,66,4,66,0,8,1,66,5,66,0,8,0,8,2,3,0,188,0,208,0,204,5,173,2,197,2,197,1,185,0,196,2,205,1,212,5,200,1,200,5,200,3,48,2,201,4,168,1,165,3,63,3,5,3,31,4,31,4,27,2,12,5,12,3,67,3,41,5,50,0,50,2,69,2,195,1,186,1,186,3,69,3,50,3,50,3,50,0,50,1,47,1,47,5,66,2,3,0,204,5,190,2,166,1,207,2,191,1,185,1,185,5,200,1,200,4,200,4,165,5,165,1,200,3,48,3,31,3,27,5,67,1,25,5,38,3,55,1,38,0,8,4,8,2,3,4,3,0,188,0,188,0,188,5,188,0,188,0,188,0,188,0,188,1,3,0,208,0,204,5,190,2,166,2,197,2,209,1,185,5,165,3,63,3,5,4,31
7,2,19,4,35,4,64,5,54,4,54,2,16,4,16,1,37,3,48,5,48,4,26,2,16,4,179,3,48,1,48,3,27,5,67,3,67,2,12,3,67,3,67,3,41,3,41,1,47,5,66,2,3,0,30,5,30,0,30,0,30,0,30,0,30,0,30,0,30,0,162,5,56,5,216,4,216,2,10,1,23,5,46,3,43,3,5,4,31,3,31,4,31,5,31,4,27,2,43,4,63,1,48,1,48,1,26,5,12,2,210,3,20,1,69,5,69,2,14,3,69,0,24,1,69,0,24,0,24,1,69,3,50,1,47,5,66,5,66,5,66,2,3,0,30,0,56,5,1,4,216,2,53,0,65,1,11,5,46,3,63,1,48,5,48,4,26,1,43,4,63,3,31,2,48,1,26,5,26,0,12,5,12,4,12,2,210,5,210,0,203,0,203,3,59,1,69,3,50,1,47,5,66,0,8,0,8,0,8,0,8,2,3,2,68,3,3,0,29,5,49,2,53,2,53,1,11,5,46,1,37,4,37,1,37,5,46,4,46,3,63,4,48,1,48,1,26,4,12,3,67,5,41,3,41,3,41,1,25,5,38,5,38,0,55,3,55,0,55,1,66,5,66,0,8,0,8,0,8,0,8,2,3,0,30,2,221,3,34,0,29,5,1,2,53,1,23,5,17,0,217,1,46,3,26,2,16,1,37,4,37,5,37,4,46,3,43,5,43,4,63,3,31,2,48,1,26,5,12,3,67,2,12,2,210,1,57,3,12,3,67,5,67,5,41,3,50,1,47,4,47,5,66,0,8,0,55,1,38,0,55,2,3,2,68,1,219,0,224,1,219,0,213,3,223,5,223,0,29,5,49,2,53,1,23,5,17,3,54,2,16,4,16,1,37,3,48,1,48,1,26,1,43,4,63,1,48,5,48,5,26,5,12,5,20,4,69,5,69,5,69,4,69,5,69,4,69,5,69,5,69,5,69,3,50,3,50,3,50,1,47,1,47,5,66,5,66,2,3,0,29,5,49,2,53,1,23,0,65,1,11,5,37,1,37,4,37,3,26,3,0,5,5,2,63,5,48,4,48,1,26,5,12,0,42,1,20,2,210,3,20,5,20,3,41,0,50,0,50,4,50,1,47,3,50,1,47,4,47,4,47,1,47,5,66,0,8,2,3,0,29,0,29,5,49,2,53,0,22,1,11,2,44,0,6,1,36,5,37,4,46,3,43,3,5,4,5,4,31,3,31,3,27,2,12,3,67,1,222,5,220,0,218,2,226,4,225,0,215,0,215,0,215,4,215,0,215,2,225,1,38,1,38,5,38,2,15,0,60,0,60,5,29,5,49,4,49,2,53,0,22,0,65,2,90,1,36,5,37,4,37,5,46,1,46,3,63,3,31,5,31,5,27,2,27,4,27,2,26,1,26,3,27,1,51,2,26,1,26,0,12,5,12,3,67,3,67,3,67,3,41,1,25,2,20,0,42,1,20,5,20,3,50,1,25,1,25,4,25,4,25,4,25,5,38,2,15,0,29,5,49,2,53,1,23,5,46,1,46,1,37,5,37,4,37,1,46,4,46,1,37,1,37,5,37,3,26,1,12,3,67,2,12,5,12,0,12,4,12,3,214,3,214,1,18,5,70,5,70,5,70,4,70,4,38,1,38,3,55,1,38,0,8,2,100,0,56,5,1,4,49,2,53,2,53,0,22,1,11,1,11,1,36,5,37,5,37,3,26,3,0,2,63,1,48,5,48,4,26,2,210,1,57,5,57,3,20,1,20,4,20,3,41,1,25,0,41,5,50,0,50
7,4,7,2,35,4,64,2,189,1,17,4,46,3,43,4,63,2,179,3,48,3,27,2,43,4,63,2,179,1,37,5,37,5,46,5,57,5,57,4,57,5,57,2,210,3,20,3,41,1,25,5,38,5,66,0,8,0,8,0,8,4,8,2,3,4,3,0,30,0,30,5,30,0,56,5,1,2,10,0,22,2,90,1,11,1,11,1,11,5,46,4,46,3,63,4,63,3,31,3,31,4,27,4,0,4,5,5,31,4,31,3,27,2,12,2,210,3,12,3,67,1,18,3,67,3,41,1,25,5,38,3,8,2,3,0,30,0,30,0,60,2,230,4,231,3,100,1,3,0,162,5,56,0,56,5,1,2,10,1,23,5,46,5,46,3,63,4,48,5,48,4,26,4,43,2,179,1,37,5,37,1,46,1,57,4,57,3,20,2,210,4,210,3,20,4,69,0,24,1,69,0,42,3,59,1,20,3,41,1,25,1,25,3,41,1,25,5,66,2,3,0,29,2,227,1,219,3,4,0,29,5,49,2,53,2,53,1,23,0,65,2,90,1,11,1,36,5,37,4,37,4,46,1,46,3,63,2,179,4,179,3,48,3,27,5,27,5,67,2,20,3,50,0,50,2,69,5,69,3,50,4,50,1,47,5,66,5,66,5,66,4,66,5,66,4,66,1,66,5,66,0,8,2,3,0,29,5,1,2,10,2,53,1,23,0,65,1,11,1,11,5,37,3,48,5,48,1,26,3,0,4,5,2,48,4,48,1,26,1,12,5,12,5,12,5,12,5,12,4,12,3,67,3,41,3,41,1,25,4,25,4,25,3,41,1,25,4,25,5,38,5,38,0,8,2,3,0,29,5,49,2,53,0,22,0,65,3,228,2,229,1,36,5,37,4,46,3,43,3,5,4,31,3,31,5,27,5,27,1,18,5,70,4,38,5,38,5,38,4,38,5,38,5,38,3,55,1,38,1,38,4,38,5,38,2,15,0,60,0,60,0,60,0,30,0,30,5,29,5,49,2,53,0,22,2,90,2,90,1,36,5,37,4,37,4,46,4,46,1,37,3,48,3,31,4,27,2,12,4,12,5,12,4,12,4,12,5,12,4,12,5,12,0,12,3,67,5,67,3,67,4,67,1,25,4,25,1,25,4,25,5,38,2,3,0,56,0,56,5,1,2,10,1,23,0,65,1,11,0,6,1,36,5,37,4,46,4,46,3,63,3,31,5,31,3,27,3,27,3,27,5,67,3,67,3,67,3,67,5,41,1,25,3,41,1,25,4,25,3,50,1,47,5,66,1,66,4,66,0,8,4,8,2,3,0,30,0,30,5,29,5,49,2,53,2,53,1,11,0,65,1,36,5,37,4,37,5,37,5,46,1,46,4,37,3,48,5,48,3,27,2,26,1,12,5,12,5,12,3,67,1,18,3,67,5,67,5,67,3,67,2,12,3,67,1,25,4,25,1,47,5,66,1,66,5,66,2,3,0,30,5,56,0,56,5,1,2,10,0,22,4,65,1,11,5,37,3,48,1,48,1,26,4,43,1,63,1,48,5,48,3,27,2,12,3,67,3,67,4,41,5,50,2,69,0,24,2,58,1,183,3,69,3,50,1,47,4,47,0,50,1,47,5,66,2,3,0,30,0,30,0,56,5,1,2,10,1,23,2,44,0,65,1,36,5,37,4,37,5,46,4,46,3,63,4,48,5,48,1,26,1,12,5,12,5,20,3,41,1,25,5,38,4,38,4,66,5,66,5,66,0,8,0,8,0,8,2,3,0,30,0,30,0,30,0,30,5,162,5,56
7,4,7,2,35,2,189,3,54,4,54,2,16,1,46,3,63,3,31,4,31,4,27,2,43,3,5,4,31,5,31,4,31,1,199,4,51,4,18,4,25,3,41,1,25,5,38,0,55,0,8,0,8,1,66,0,55,0,8,0,8,1,66,0,8,0,8,0,8,2,3,0,30,1,100,0,56,5,49,4,49,5,49,2,53,4,53,2,90,1,11,1,11,1,36,4,36,3,232,4,233,2,44,2,174,1,36,5,37,3,26,0,26,0,12,3,67,0,164,2,164,3,127,2,164,1,18,3,41,1,47,5,66,5,66,5,66,5,66,0,55,4,55,1,38,2,3,0,30,5,162,5,56,5,1,2,10,1,23,5,46,4,46,3,43,4,63,4,48,4,48,1,26,4,43,4,63,4,48,1,48,1,26,4,12,5,12,5,12,5,12,3,67,3,67,3,67,3,67,5,67,3,67,3,67,1,18,5,38,5,38,1,38,0,55,1,66,0,8,2,3,0,29,5,49,2,53,0,22,0,65,2,90,1,36,5,37,4,37,1,46,1,46,1,37,1,37,4,37,4,46,4,57,5,57,4,57,2,14,0,39,5,39,4,39,1,183,3,69,1,69,4,69,0,24,5,24,1,69,4,69,3,50,3,50,1,47,5,66,5,21,5,21,2,4,0,56,5,1,4,216,2,53,2,90,1,11,5,46,5,37,4,37,5,37,4,46,1,46,3,63,3,31,5,31,5,27,2,12,3,67,3,67,3,67,5,67,3,41,2,20,3,41,3,41,4,50,3,50,1,47,5,66,5,66,5,66,0,8,0,8,0,8,2,3,0,29,5,49,2,53,1,23,0,65,2,90,2,229,1,36,1,36,5,37,5,46,4,46,3,63,3,31,5,31,4,27,0,127,4,127,2,214,4,214,3,127,1,18,5,70,5,38,4,66,5,66,0,8,0,8,0,8,0,8,0,8,0,8,0,8,0,8,2,3,0,29,0,29,5,49,2,53,2,53,0,65,1,11,4,36,5,37,4,37,4,46,4,46,5,37,1,37,5,37,3,26,2,210,1,57,5,57,3,12,3,67,3,67,4,67,2,12,0,12,1,12,5,12,3,41,1,47,4,47,5,66,5,66,1,66,0,8,2,3,0,29,5,49,2,53,1,23,5,46,5,46,3,63,3,31,2,48,1,48,1,26,4,43,1,63,3,31,2,48,5,26,1,12,5,12,5,12,5,20,5,20,5,20,5,20,5,20,2,210,3,20,3,41,3,41,1,25,3,41,3,41,3,41,1,25,5,38,0,8,0,237,2,4,0,29,5,49,2,53,0,22,2,53,1,11,5,46,3,63,3,31,4,31,3,27,3,0,4,5,4,31,3,31,3,31,5,27,5,27,3,67,3,67,3,67,2,12,5,12,3,67,3,67,4,41,3,41,4,41,1,25,3,41,1,25,1,25,5,38,4,38,5,38,2,3,1,3,0,29,5,49,2,53,0,22,4,65,0,65,2,229,0,6,1,36,5,46,3,43,3,5,4,31,4,31,4,27,2,12,4,12,5,12,3,67,3,67,3,67,3,67,3,67,3,67,1,18,1,18,1,18,3,41,1,25,4,25,5,38,1,38,1,66,0,8,2,4,0,29,5,49,2,53,1,23,2,44,2,44,1,36,5,37,5,37,1,46,3,43,4,63,3,31,3,31,3,27,2,27,3,27,2,12,3,67,3,67,0,164,3,127,5,236,1,141,5,238,5,238,3,234,4,234,5,72,1,239,5,94,0,235,1,94,1,79,0,240,2,3,0,29,5,49,2,53
7,2,19,4,35,4,64,5,54,2,189,4,16,3,43,2,179,1,37,5,37,4,46,1,46,3,63,3,31,3,31,2,48,3,27,2,12,4,12,3,67,1,18,5,70,4,38,0,55,1,38,4,38,4,38,4,38,4,38,0,55,0,55,0,8,0,8,0,8,2,3,0,30,5,29,5,49,2,53,2,53,0,22,1,11,4,11,5,37,5,37,4,37,1,46,1,46,3,63,2,179,4,179,1,46,5,57,5,57,4,57,5,183,3,69,3,50,0,50,4,50,4,50,3,50,1,47,4,47,5,66,5,66,4,66,4,66,5,66,0,8,2,3,0,29,5,49,2,53,2,53,0,65,2,90,1,36,5,37,3,48,5,48,4,26,2,16,1,37,4,37,5,37,1,46,3,12,3,67,3,41,1,25,5,38,5,38,5,38,3,55,1,38,0,55,2,15,0,60,0,60,0,60,0,60,1,15,0,60,0,30,5,162,0,56,5,1,2,10,2,53,1,11,5,46,3,63,4,48,3,31,2,26,1,43,4,63,1,48,4,48,5,26,4,12,5,12,5,20,4,20,5,20,3,41,5,41,3,50,1,47,2,69,3,50,1,47,5,66,0,8,1,66,0,8,0,8,0,8,0,8,2,4,0,29,5,49,2,53,1,23,0,65,3,228,2,229,4,229,0,6,0,65,1,11,1,11,5,37,1,37,3,48,3,27,2,12,5,20,5,69,3,50,3,50,4,50,1,47,1,47,3,50,4,50,5,50,1,47,4,47,5,66,2,3,0,60,0,60,0,60,0,60,2,227,1,242,0,224,3,223,5,223,0,56,5,1,2,10,1,243,2,2,0,65,1,11,5,46,3,63,3,31,3,31,3,27,2,43,3,5,2,63,1,48,5,48,5,26,4,26,0,12,3,67,4,67,1,18,5,38,5,66,3,8,0,8,0,8,0,8,1,66,5,66,0,8,0,8,0,8,0,8,2,3,0,30,5,30,0,56,5,1,2,10,2,53,1,11,0,65,1,36,1,36,5,37,4,46,1,46,3,63,4,48,3,31,5,27,2,12,1,12,5,20,4,20,5,20,5,69,5,69,5,69,5,69,4,69,5,69,0,24,1,69,3,50,1,47,5,66,2,3,0,30,0,30,5,56,5,1,2,10,2,53,1,11,4,11,5,37,3,48,5,48,4,26,2,16,1,37,4,37,1,37,5,46,4,46,4,57,4,57,3,20,1,69,3,50,3,50,1,47,2,69,3,50,1,47,4,47,5,66,0,8,0,8,0,8,0,8,0,8,0,8,2,3,0,29,5,49,2,53,1,23,5,46,4,46,1,37,4,37,5,37,4,46,1,46,1,37,4,37,1,37,5,46,1,57,5,57,5,57,5,57,4,57,1,57,0,203,1,57,3,20,1,69,5,69,0,24,3,32,1,69,4,69,3,50,2,69,3,50,2,69,1,33,1,33,5,33,3,241,2,33,1,33,3,241,1,9,5,21,0,244,2,4,0,29,5,49,2,53,2,53,1,11,0,65,3,228,2,229,1,36,4,36,5,46,4,46,1,37,1,37,3,48,1,26,2,210,3,20,0,24,1,69,5,69,4,69,3,50,4,50,1,47,5,66,5,66,1,66,4,66,0,8,2,3,4,3,0,30,0,30,0,30,5,29,5,49,2,53,1,23,0,65,0,65,1,11,1,36,1,36,4,36,0,65,1,11,5,37,3,48,1,48,5,26,2,210,5,210,3,20,3,41,2,69,5,69,5,69,0,24,0,24,0,24,0,24,1,69,3,50,1,47,5,66,5,66
7,3,7,2,35,4,64,5,54,3,71,4,27,4,0,4,0,4,5,2,48,3,31,4,27,2,43,4,63,3,31,4,31,3,27,3,67,3,41,0,41,4,41,1,25,5,38,4,38,0,55,0,55,0,55,0,55,0,8,0,8,0,8,0,8,2,3,0,60,0,60,0,30,5,29,5,1,4,1,2,10,0,22,1,11,5,46,3,63,1,48,4,48,4,26,3,0,3,5,2,63,5,48,3,31,5,27,3,67,3,67,3,67,3,67,3,67,4,41,3,41,3,50,4,41,1,25,5,38,1,38,5,38,1,38,1,38,0,55,2,15,0,30,5,30,5,29,5,49,2,53,1,23,1,11,5,46,3,63,3,31,3,31,4,27,2,43,5,63,4,48,1,48,0,26,4,12,3,67,5,41,0,41,1,25,4,25,5,66,1,66,3,8,1,66,3,8,0,8,1,66,1,66,5,66,4,66,0,8,0,8,2,3,0,29,5,49,2,53,1,23,0,65,2,90,1,36,5,37,5,37,1,46,1,46,3,63,4,48,1,48,5,26,0,12,5,20,5,20,3,50,5,50,1,47,5,66,0,8,0,8,0,8,4,8,0,8,0,8,0,8,0,8,0,8,0,8,2,3,0,30,0,56,5,1,2,53,0,22,1,23,1,11,5,46,4,37,1,37,4,37,3,26,4,43,2,179,1,37,1,37,4,46,1,57,5,57,3,20,0,24,5,24,2,58,3,32,1,69,5,69,2,14,3,69,3,50,1,47,5,66,2,3,0,30,0,30,0,30,5,30,5,29,5,1,2,10,1,23,5,46,1,46,4,37,3,48,4,48,1,48,1,26,4,43,4,63,5,48,1,48,1,26,5,12,3,41,3,41,3,50,4,50,0,50,1,47,3,50,3,50,0,50,0,50,1,47,5,66,4,66,2,3,3,8,0,8,0,8,2,100,0,56,5,1,2,10,0,22,0,65,1,11,1,36,5,37,3,48,4,48,4,26,4,43,3,5,4,31,2,48,1,26,5,12,5,12,2,210,1,57,5,57,5,57,5,57,5,57,3,20,1,69,2,14,3,69,3,50,1,47,5,66,5,66,5,66,0,8,2,3,0,29,5,49,2,53,0,22,2,53,1,11,1,11,5,46,4,37,5,37,5,37,4,46,1,46,3,63,2,179,1,37,5,37,4,46,5,57,5,57,3,20,3,50,5,50,2,69,5,69,3,50,1,47,5,66,0,8,0,8,0,8,0,8,0,8,0,8,0,8,0,8,2,3,0,29,0,56,5,1,2,10,0,22,2,90,2,90,1,36,4,36,0,6,0,6,1,11,5,46,3,63,1,48,4,48,3,27,1,18,3,67,3,41,3,41,2,20,2,210,3,20,3,41,5,50,3,50,0,50,3,50,1,47,4,47,5,66,2,3,0,60,0,60,0,30,5,29,5,1,2,10,1,23,2,44,1,11,1,36,4,36,5,37,4,46,5,46,1,37,3,48,5,48,1,26,0,12,2,210,3,12,5,12,3,67,5,67,1,18,4,25,4,25,1,47,5,66,5,66,1,66,0,8,2,3,3,8,2,3,3,8,2,3,0,29,5,49,2,53,4,53,1,11,1,11,5,46,4,46,3,43,4,43,2,179,1,37,4,37,4,46,3,43,2,179,1,37,5,37,1,46,5,57,3,12,3,67,5,67,5,67,1,18,2,12,3,41,0,41,1,25,5,38,0,8,0,8,3,8,1,66,1,66,5,66,2,3,0,30,5,56,5,1,2,10,0,245,2,53,1,11,2,44,1,36,5,37,1,37
7,4,7,2,35,4,64,2,189,1,17,5,46,1,46,1,37,3,48,5,48,1,48,1,26,4,43,3,5,4,31,1,199,5,271,3,251,1,70,5,70,5,70,5,220,5,220,5,220,5,220,5,70,2,15,1,3,2,68,0,52,0,273,1,61,3,15,0,60,5,60,1,15,0,29,5,49,2,53,0,22,1,11,5,46,3,63,3,31,5,31,2,26,4,43,4,63,1,48,3,31,2,26,0,26,0,12,5,12,3,41,1,25,5,38,5,38,5,38,4,66,5,66,5,66,4,66,4,66,3,8,0,8,0,8,0,8,2,3,0,30,5,30,5,29,5,49,2,53,4,53,1,11,5,46,3,63,4,48,5,48,1,26,5,43,5,63,4,48,1,48,3,27,2,26,1,12,5,12,3,67,5,41,2,20,2,14,2,14,2,14,3,69,3,50,3,50,4,50,4,50,0,50,1,47,4,47,1,47,5,66,2,3,0,29,5,1,2,10,2,53,1,11,2,44,2,174,2,174,1,36,0,65,0,65,1,36,1,36,0,6,1,11,5,57,4,57,3,20,1,20,4,20,5,20,3,41,1,25,5,38,0,55,0,8,5,8,0,8,0,8,0,8,0,8,0,8,2,100,0,162,5,56,5,1,0,216,2,53,1,11,0,65,1,36,5,37,5,37,3,26,1,43,4,43,4,63,4,48,1,48,5,26,0,12,3,67,0,127,3,127,5,236,3,236,3,236,4,236,0,236,3,236,3,261,2,275,1,256,2,265,2,260,1,152,4,152,5,159,3,50,4,241,1,9,5,21,2,253,0,29,5,49,2,53,0,22,1,101,5,121,3,99,5,142,1,254,5,139,1,259,5,255,4,264,5,277,5,254,5,139,5,104,5,260,5,104,5,152,2,274,3,152,4,73,5,73,5,73,3,263,1,270,5,270,5,270,5,270,5,270,5,270,4,270,5,270,2,276,3,267,5,262,1,246,5,252,0,258,2,4,0,29,5,49,2,53,1,23,1,11,4,11,1,36,5,37,5,37,3,26,2,16,3,63,3,77,1,249,5,257,2,169,5,169,4,169,2,45,4,45,1,272,1,272,5,272,0,273,0,273,1,272,3,3,0,30,0,30,4,30,4,30,5,30,0,30,1,3,0,29,5,49,2,53,4,53,1,11,2,44,0,6,1,36,2,174,1,11,5,46,3,63,5,48,3,77,2,26,0,12,3,266,3,266,2,20,2,210,3,20,3,72,2,69,1,69,4,69,3,86,1,109,5,79,5,79,5,79,1,79,0,240,0,240,2,100,0,56,5,1,2,10,1,23,2,44,1,11,1,11,5,37,3,48,4,48,1,26,3,144,4,137,4,77,4,77,3,85,4,266,2,12,5,20,0,42,1,20,4,20,5,20,3,86,1,109,1,109,4,109,4,109,5,79,2,3,1,3,4,3,0,30,5,162,0,162,0,56,5,1,2,10,2,53,1,11,2,44,0,6,1,36,5,37,5,37,1,46,1,46,3,63,3,77,2,48,1,26,1,26,5,12,4,12,3,266,3,266,1,248,5,268,2,247,3,215,1,269,3,250,0,235,1,94,1,94,0,235,0,235,0,235,1,94,5,94,2,3,0,29,0,29,5,49,4,49,2,53,0,22,1,11,1,11,5,37,3,48,1,48,5,26,1,43,5,63,1,63,1,63,4,48,1,48,5,26,4,26,0,12,5,12,5,12,0,12,0,12,0,12,2,210,5,210,5,210,5,210,1,183,3,69,1,69,3,86,1,109,4,109,5,79,0,240,2,3,0,29,5,49
7,2,19,4,35,2,189,1,17,4,17,1,46,1,46,1,37,4,37,5,37,5,46,3,43,4,63,3,31,2,48,5,26,2,210,5,210,3,12,2,210,0,203,5,203,1,57,1,57,3,12,3,67,3,41,3,41,1,25,1,25,3,41,1,25,5,38,5,38,0,8,2,34,0,56,0,56,5,1,4,216,2,53,0,65,1,11,5,37,1,37,1,37,5,37,3,26,2,16,3,63,1,48,1,48,3,27,0,164,4,164,2,164,4,164,4,164,3,127,1,25,5,38,2,15,4,15,4,15,5,15,0,60,4,60,0,60,0,60,0,60,0,60,5,30,5,29,5,49,2,53,1,23,0,65,1,11,5,37,4,37,3,48,2,16,3,43,4,63,4,48,1,48,4,26,2,210,3,12,3,67,3,67,1,18,5,38,5,38,5,38,2,15,2,45,0,52,1,61,0,52,0,52,4,52,5,193,1,202,1,186,3,69,3,241,1,9,5,21,2,4,0,284,5,173,2,197,1,207,0,196,0,196,1,212,5,200,5,200,4,165,5,165,3,43,2,201,1,200,1,200,1,165,3,12,0,12,5,12,3,67,5,67,3,67,3,67,3,67,1,25,4,25,3,41,1,25,3,41,1,25,4,25,1,25,4,25,1,47,5,66,2,34,0,204,5,190,2,166,2,197,1,207,0,196,1,185,1,185,1,212,5,200,5,200,3,26,0,279,1,63,4,48,4,48,4,26,5,12,5,12,2,281,5,281,3,20,3,41,3,41,0,50,1,47,5,66,4,66,1,66,4,66,5,66,0,8,0,55,2,3,4,15,0,188,5,204,0,204,5,190,2,166,1,207,0,196,1,185,5,200,3,48,5,48,1,26,1,43,4,43,1,63,1,48,4,48,5,48,3,27,3,67,0,164,4,164,3,127,2,164,2,164,1,18,2,20,3,41,3,41,0,41,1,25,1,47,5,66,4,38,1,38,3,55,1,66,2,100,0,204,5,190,2,166,1,207,0,196,0,196,1,212,5,200,5,200,4,165,1,165,1,200,1,200,4,200,4,165,4,202,5,202,1,202,5,186,5,186,5,186,0,283,5,273,0,282,3,280,0,162,0,162,0,30,0,30,0,30,0,30,0,30,0,30,0,30,5,56,5,1,2,10,2,53,0,65,2,90,1,36,5,37,3,48,5,26,4,43,3,0,2,63,4,48,1,48,3,27,2,12,5,12,5,12,3,67,1,18,5,70,5,70,2,169,0,169,4,169,1,169,0,60,0,60,3,278,1,15,2,45,3,15,0,60,0,60,0,40,5,206,2,53,1,23,0,22,0,65,0,65,1,36,4,36,5,37,4,46,1,46,3,63,3,31,3,31,3,27,3,67,1,18,5,38,5,38,2,15,3,55,0,55,2,15,0,60,0,60,5,60,0,60,0,60,0,60,0,60,1,3,0,30,0,30,5,30,5,29,5,49,2,53,1,23,2,44,1,11,5,46,3,63,4,48,4,48,4,48,1,26,2,16,1,37,1,37,4,37,1,46,3,12,3,214,5,214,2,214,4,214,3,214,1,222,5,220,4,70,4,70,5,38,3,55,0,55,0,55,0,55,2,15,0,60,0,60,5,30,5,56,5,1,2,10,1,23,2,44,1,11,1,36,0,6,4,6,1,11,4,11,5,46,3,63,3,31,3,31,4,27,1,18,3,41,3,50,3,50,5,50,4,50,3,50,4,50,2,69,2,14,0,203,1,57,3,69,1,69,3,50,1,47,5,66,2,3,0,30,5,56,5,1,2,10,0,22,1,23,1,11
