58,0,66,3,41,5,14,5,14,2,63,5,63,5,63,0,55,5,6,3,54,5,25,3,25,2,5,0,57,5,45,3,15,5,67,2,71,0,23,5,52,5,35,3,73,5,70,4,70,4,42,4,2,2,11,4,11,3,2,2,11,2,28,3,11,5,11,3,42,2,69,5,43,4,43,3,29,3,65,5,12,2,10,2,27,0,38,5,68,3,4,5,25,2,5,0,57,5,6,3,54,5,67,2,71,5,71,0,13,5,76,5,48,5,26,2,32,4,32,4,32,3,1,3,73,0,56,0,17,4,17,3,47,3,47,4,47,3,47,5,42,5,42,4,70,3,29,3,29,3,12,2,10,2,27,0,3,5,68,3,4,3,4,5,25,2,5,0,57,5,6,3,54,3,15,5,67,2,71,0,23,5,52,5,48,4,48,4,48,5,26,3,73,5,70,4,29,4,29,3,29,4,65,5,65,0,16,4,16,3,65,3,65,3,65,3,65,3,65,3,65,0,22,1,21,2,0,0,38,5,6,3,54,2,75,3,54,2,75,3,54,5,25,2,44,5,44,5,44,0,23,5,52,3,15,5,67,2,71,5,71,5,20,0,13,5,49,5,60,3,34,2,51,5,1,0,48,5,48,0,26,3,73,3,73,5,70,2,69,3,29,4,29,3,29,3,29,3,29,3,65,5,65,1,40,1,36,2,31,0,74,5,68,3,54,5,25,2,5,0,57,5,6,3,54,5,25,5,25,5,25,2,5,0,57,5,45,5,7,3,8,0,53,4,53,3,8,3,8,3,8,2,37,3,8,2,37,3,8,3,8,3,8,4,8,5,2,3,42,4,42,3,70,3,29,3,12,4,64,2,27,5,61,5,61,0,38,5,6,3,54,2,75,3,54,5,25,2,44,5,71,0,23,5,52,3,46,5,72,2,20,0,13,5,76,5,48,5,26,3,34,0,56,4,17,3,34,0,56,4,56,5,56,3,34,0,56,4,56,5,56,3,34,5,29,5,29,3,29,5,29,3,65,1,36,2,31,0,74,5,68,3,4,5,30,2,62,5,5,0,57,5,6,3,54,2,19,3,15,5,67,3,67,2,71,5,20,0,13,5,76,5,48,0,48,0,48,0,26,3,34,2,9,3,34,0,17,2,1,3,34,3,34,5,29,4,29,3,29,3,29,3,29,3,29,3,65,4,65,1,36,2,31,0,74,5,33,3,4,5,30,2,62,0,57,3,25,2,44,5,44,0,18,5,45,3,54,5,25,2,71,0,23,5,52,5,35,3,73,5,70,4,70,4,70,2,69,4,69,2,50,5,50,5,50,3,69,3,29,3,29,4,29,4,65,5,65,4,65,3,65,1,40,5,36,2,31,0,74,5,68,3,54,3,54,3,54,5,25,2,44,0,18,5,52,3,15,5,67,3,67,4,67,3,67,3,67,2,71,0,23,5,52,5,35,0,48,2,32,3,1,4,51,3,73,5,70,4,29,0,24,0,24,4,39,3,29,3,29,4,70,4,29,5,29,3,65,4,65,4,65,0,22,1,21,2,0,0,38,5,6,3,54,2,59,2,19,0,52,3,15,5,67,2,71,0,23,5,52,3,15,5,67,2,71,0,13,5,76,5,48,5,48,2,32,2,32,3,1,5,51,5,1,3,34,0,56,4,56,4,56,3,34,5,70,5,29,3,29,5,29,3,65,5,65,4,65,0,22,1,21,2,0,0,38,5,6,3,54,2,19,3,15,5,67,2,71,5,71,5,20,0,13,5,76,3,46,5,72,3,72,2,20,0,13,5,76,5,26,3,73
58,4,83,3,83,3,83,3,83,5,83,5,83,5,83,5,83,5,83,5,83,3,83,5,83,0,66,2,104,3,100,5,85,2,112,0,92,5,52,3,15,5,67,5,67,2,71,0,23,5,52,3,15,5,67,2,71,5,71,5,20,0,13,5,76,5,48,5,48,5,26,5,26,3,34,0,56,4,56,4,56,5,56,5,56,4,17,4,80,4,80,3,47,3,47,5,70,3,70,3,29,4,65,5,12,2,10,2,27,0,38,5,68,3,4,0,110,5,110,5,110,5,110,3,54,5,25,2,5,0,115,5,6,3,54,5,67,2,71,5,20,5,77,5,20,0,13,5,76,5,48,3,34,4,34,4,34,0,17,4,56,4,17,5,56,4,17,5,17,5,17,5,17,4,17,4,56,5,56,2,51,3,108,0,113,0,113,3,93,2,102,3,89,3,89,5,101,2,109,0,109,2,81,5,61,5,63,0,55,5,6,3,54,2,75,3,54,5,25,3,67,2,71,0,23,5,52,3,46,3,46,5,72,2,20,0,13,5,76,5,48,3,34,5,70,3,70,4,29,4,29,5,29,4,65,4,65,0,16,3,29,3,29,3,29,3,70,5,29,3,29,5,65,4,65,3,65,1,36,1,91,2,90,5,90,1,31,0,31,0,74,5,68,3,54,5,25,2,71,5,71,0,23,5,52,3,15,5,67,2,71,0,23,5,52,5,35,3,47,3,47,2,79,3,8,0,53,4,53,4,53,3,8,4,8,3,8,3,47,5,70,2,69,5,43,5,86,5,43,5,43,3,29,0,22,1,21,2,0,0,38,5,68,3,4,5,30,2,62,5,87,5,87,5,87,0,118,5,6,3,54,2,75,3,54,5,67,3,25,2,44,5,71,5,71,5,20,0,13,5,76,5,26,3,34,0,17,5,56,4,56,0,17,3,73,4,73,3,34,0,56,5,56,4,56,5,56,3,34,4,108,4,108,0,113,3,108,3,108,3,93,3,93,2,102,3,82,5,101,2,61,5,61,0,55,5,6,3,54,2,75,3,54,5,67,3,67,3,67,2,71,5,71,5,71,5,71,5,71,0,23,5,52,3,46,5,72,2,20,0,13,5,76,5,48,5,48,4,48,2,32,3,51,3,34,0,56,4,56,4,56,5,56,5,56,5,56,3,34,5,29,5,29,3,29,3,29,5,29,2,39,0,95,1,116,0,22,1,21,2,0,0,38,5,6,3,54,2,75,3,54,5,25,2,44,5,44,5,71,0,23,5,52,3,15,5,67,2,71,0,23,5,76,5,48,4,48,5,48,5,48,3,73,4,34,0,56,4,56,3,34,0,56,3,73,0,56,5,56,5,56,5,17,4,17,5,17,5,17,5,17,2,107,5,107,3,98,3,98,3,93,3,82,2,94,3,89,5,101,2,61,0,55,5,6,3,54,5,25,2,5,0,57,5,45,3,54,2,75,3,15,5,67,2,71,0,23,5,52,5,35,4,35,3,47,2,37,3,47,5,2,0,78,4,111,2,114,2,28,5,28,3,114,2,28,3,114,2,50,5,50,5,105,5,105,5,50,3,84,1,84,3,12,2,10,2,81,0,38,5,6,3,54,1,117,3,106,0,88,5,88,5,88,5,88,5,96,5,96,5,96,5,96,5,96,5,96,5,96,5,96,5,96,5,96,5,96,5,96,5,96,5,96,5,96,5,96,2,97,3,46,5,72,3,72,2,20,0,103,5,49,3,99,5,72,3,72,2,20,0,13,5,76,5,35,3,47,3,47,5,70,2,69,4,69,4,69,4,69,4,69
58,2,119,0,123,3,41,5,14,2,63,5,63,0,55,5,6,3,54,2,75,3,54,2,75,3,54,2,75,3,54,5,25,2,44,0,18,5,52,3,15,3,15,5,67,3,67,2,71,5,20,0,13,5,76,5,48,5,48,0,26,3,34,5,70,4,29,4,29,4,29,4,65,4,65,4,65,0,16,4,16,4,16,4,16,3,65,4,65,4,65,3,65,5,12,2,10,2,27,0,38,5,68,3,54,5,25,3,67,2,71,5,20,0,13,5,76,3,99,5,121,0,125,2,125,2,125,2,77,0,103,5,76,5,48,5,48,5,48,5,48,5,48,3,34,0,56,4,56,3,34,3,34,0,17,5,56,3,34,5,29,3,29,5,65,5,65,0,16,3,65,0,22,1,21,2,0,0,38,5,6,3,54,5,67,2,71,0,23,5,52,3,15,3,46,5,72,2,20,0,13,5,76,5,26,5,26,3,34,0,56,4,56,4,56,5,56,4,56,4,17,4,80,4,80,4,17,4,17,3,73,5,29,5,29,3,65,0,16,3,65,3,12,0,22,2,22,1,36,2,31,0,74,5,68,3,4,5,30,2,62,0,57,5,6,3,54,5,25,5,25,5,25,2,5,0,57,5,45,5,7,4,7,3,8,4,8,0,53,0,53,2,37,3,8,0,80,4,17,5,80,3,47,5,70,5,29,5,29,5,29,3,65,5,65,1,40,0,22,1,21,2,0,0,38,5,6,3,54,2,75,3,15,5,67,2,44,5,71,0,23,5,52,3,15,5,67,3,67,2,71,0,13,5,76,5,35,4,35,0,48,5,35,0,35,2,126,0,122,3,1,0,48,3,34,3,34,3,34,4,34,4,34,5,65,3,65,5,65,5,65,4,65,0,22,4,10,2,27,0,38,5,68,3,4,5,30,2,5,0,57,5,6,3,54,2,19,3,15,5,67,5,72,3,72,2,20,0,103,5,49,5,48,4,48,5,48,4,48,3,34,0,56,4,56,3,34,5,29,5,29,4,65,2,16,4,16,5,16,4,16,5,16,3,65,3,65,3,65,1,36,1,21,2,0,0,0,0,38,5,6,3,54,5,25,2,44,5,44,5,44,0,23,5,52,3,15,5,25,2,71,0,23,5,52,5,35,2,32,3,1,4,1,5,1,5,1,5,1,3,73,3,34,0,56,5,56,3,34,5,29,3,29,3,29,3,29,3,29,3,65,1,40,5,36,2,31,0,74,5,68,3,4,5,25,2,5,5,44,5,44,0,18,5,52,3,15,5,67,2,20,5,20,5,20,0,103,5,49,5,26,3,34,0,17,5,56,4,17,3,34,4,34,5,29,4,29,0,39,3,29,4,65,0,16,2,127,4,127,5,127,5,127,0,124,5,124,3,12,3,12,1,36,2,90,2,120,3,0,0,38,5,6,3,54,5,25,2,44,5,44,5,44,0,18,5,52,3,15,3,15,3,15,3,15,5,67,3,67,3,67,5,67,3,67,2,71,0,23,5,52,5,35,4,48,0,48,5,48,0,48,5,48,3,73,5,29,2,86,4,127,2,105,4,105,3,86,3,29,5,29,3,29,3,65,5,65,1,40,2,90,5,31,0,74,5,68,3,54,5,25,2,5,0,57,5,6,3,54,2,75,3,54,2,19,3,15,2,19,3,15,5,67,2,71,0,23,5,52,5,35,5,35,3,47,0,80,4,17,3,34,0,56,5,56,4,17,0,56,5,56,5,56,3,34,3,34,5,29,3,29,3,65,5,65,3,65,2,22,1,21,2,0,0,0,0,74,5,68,3,4
58,0,66,5,66,5,128,5,128,3,100,0,128,3,100,5,85,2,112,0,92,5,52,3,15,3,15,5,67,3,67,3,67,2,71,0,23,5,52,3,15,5,67,2,71,5,44,5,71,5,71,0,23,5,52,5,35,5,48,0,48,5,48,4,48,3,34,0,56,4,56,4,113,4,113,2,130,3,34,5,29,5,29,5,29,3,29,3,65,3,65,1,40,2,90,5,31,0,74,5,68,3,54,5,25,2,44,0,18,5,45,3,54,5,67,2,71,5,71,5,20,5,20,5,71,0,13,5,76,5,26,3,34,2,9,4,9,4,51,3,73,0,56,5,56,4,17,4,80,3,47,4,73,5,29,4,29,5,29,3,29,3,65,5,65,4,65,1,36,2,31,0,74,5,68,3,54,2,129,3,54,5,67,2,71,5,71,0,23,5,52,3,15,5,67,2,71,0,13,5,76,5,48,2,32,4,32,2,32,2,32,4,32,2,32,5,50,4,105,3,86,5,86,5,43,3,29,5,29,0,39,3,29,3,29,3,29,5,29,0,22,1,21,2,0,0,74,5,68,3,54,3,54,5,25,2,5,0,57,5,6,3,54,5,25,2,71,5,71,5,20,5,20,5,20,5,20,5,20,5,20,5,20,5,20,5,77,5,20,0,13,5,76,5,26,2,32,0,131,3,51,5,1,0,26,3,73,3,73,3,73,5,70,4,29,4,29,4,29,5,29,3,29,3,29,3,65,5,65,1,40,1,36,2,31,0,74,5,33,3,4,5,30,5,25,5,25,2,5,0,57,5,6,3,54,5,67,2,71,0,23,5,52,5,48,0,48,5,48,5,48,3,34,0,17,4,17,5,17,5,17,4,17,4,17,5,56,3,34,5,29,5,29,3,29,3,65,5,65,3,65,4,12,2,10,2,27,0,38,5,68,3,54,2,129,3,54,2,75,3,54,5,25,2,44,5,44,0,18,5,52,3,15,3,15,5,67,3,67,2,71,5,20,0,13,5,76,5,26,3,34,0,53,0,56,0,17,5,56,4,17,3,73,5,29,0,39,3,65,3,65,4,65,5,65,3,65,5,65,4,65,5,65,5,65,0,22,1,21,2,0,0,38,5,6,3,54,2,75,3,54,2,19,3,15,5,67,2,71,5,71,0,23,5,52,3,46,5,72,2,20,0,13,5,76,5,48,5,26,2,32,2,32,3,9,3,34,5,29,5,29,0,24,4,24,3,70,4,29,4,29,3,70,4,29,3,29,3,29,4,65,1,40,1,36,2,31,0,74,5,68,3,54,2,129,3,54,5,25,2,5,5,5,0,57,5,6,3,54,5,67,2,71,5,71,5,20,0,13,5,76,5,26,3,34,4,34,0,17,0,17,3,34,0,56,4,56,3,34,5,29,5,29,4,29,3,29,3,29,5,65,4,65,5,65,3,65,0,16,3,12,2,10,1,21,0,109,2,63,0,55,5,6,3,54,2,19,3,15,5,72,2,20,5,20,0,13,5,76,3,46,5,72,3,72,2,20,0,13,5,76,5,26,3,34,4,34,5,29,4,29,5,29,4,65,4,29,4,29,3,29,5,29,0,24,4,24,2,43,5,69,3,29,3,29,3,65,3,65,2,22,1,21,2,0,0,38,5,6,3,54,5,25,2,44,0,18,5,45,3,54,5,67,2,71,5,71,5,20,0,13,5,49,5,26,4,26,3,34,0,53,4,53,3,34,5,70,4,29,4,29,5,29,5,29,4,29,5,29,5,29,3,65,3,65,4,65,3,65,1,40,2,90,1,31,0,74,5,68,3,4
58,2,119,3,83,5,83,5,83,5,83,0,66,2,104,3,41,5,14,2,112,0,92,5,52,3,15,5,67,2,71,5,71,5,71,5,71,5,71,5,71,5,71,5,20,0,13,5,76,3,46,3,46,5,72,2,77,5,77,0,13,5,76,5,26,4,26,3,34,2,51,3,73,4,34,5,29,5,65,0,16,4,16,4,16,4,16,3,65,3,65,3,65,5,65,3,65,4,65,3,65,0,22,1,21,2,0,0,0,0,38,5,6,3,54,2,129,3,54,5,67,2,71,5,71,5,71,0,23,5,52,3,54,5,67,3,67,3,67,2,71,0,18,5,45,5,35,4,35,5,35,5,48,5,48,5,48,5,48,5,48,3,73,5,29,0,39,4,39,4,39,4,39,3,70,4,70,3,29,3,65,3,65,0,22,1,21,2,0,0,74,5,68,3,54,5,25,2,5,0,57,5,6,3,54,2,19,3,15,5,67,2,71,0,23,5,52,5,35,4,35,4,35,4,35,3,47,3,47,3,8,0,80,4,53,3,47,5,42,3,70,4,70,2,69,5,43,4,86,5,43,4,43,5,43,3,137,1,116,3,140,5,141,1,133,0,102,3,89,5,14,5,14,2,63,0,55,5,6,3,54,5,67,2,71,5,71,5,71,5,71,0,23,5,52,3,15,3,15,5,67,2,71,5,71,5,20,0,13,5,76,5,48,5,48,4,48,3,34,4,73,5,29,4,29,0,39,4,39,4,24,4,39,3,29,3,29,3,29,3,29,3,29,3,65,3,65,1,138,2,90,2,120,3,0,0,38,5,6,3,54,5,25,2,44,0,18,5,45,3,54,5,25,2,44,5,71,0,23,2,132,3,20,5,20,5,20,0,13,5,76,5,48,5,48,2,32,3,1,3,73,5,70,5,70,4,29,0,39,3,29,5,70,2,69,3,29,3,70,4,70,4,70,3,29,3,29,3,65,4,12,1,135,2,0,0,38,5,68,3,54,5,25,2,44,0,18,5,52,3,15,5,67,2,71,0,13,5,76,5,48,4,26,2,32,0,131,3,9,3,34,5,29,4,65,0,16,4,16,4,16,3,65,0,39,5,73,4,73,5,24,4,39,3,29,5,65,3,12,1,135,2,0,0,38,5,68,3,54,2,129,3,54,2,19,3,15,5,67,3,67,3,67,2,71,0,23,5,52,3,15,5,67,2,71,0,23,5,52,5,35,0,35,5,48,5,48,5,48,3,73,5,70,4,70,4,70,0,24,3,70,5,70,5,70,5,70,0,24,3,70,5,29,3,65,1,138,5,139,2,31,0,74,5,68,3,54,5,25,5,25,2,5,0,57,5,45,3,54,2,19,3,15,5,134,2,136,0,23,5,52,5,35,5,48,5,48,5,48,5,26,4,60,4,60,4,26,3,34,5,65,0,16,4,16,2,127,0,124,5,124,3,65,3,65,3,65,5,65,2,22,2,22,2,10,2,27,0,38,5,68,3,54,3,54,5,25,5,25,5,25,5,25,5,25,5,25,5,25,5,25,2,5,0,57,5,6,3,54,5,67,2,136,0,23,5,52,5,35,3,73,3,34,0,17,5,56,4,56,4,56,4,56,5,56,4,17,5,17,5,56,3,34,4,34,3,34,5,29,3,65,5,65,4,65,1,139,2,31,0,74,5,68,3,54,2,129,3,54,2,19,3,15,5,67,2,71,5,71,5,71,5,71,5,71,0,23,5,52,3,46,5,72,2,20,0,13,5,76,5,26,3,34,2,51,3,73,0,17,4,56,5,17,3,73,0,17,4,17,4,17
58,3,83,0,66,5,66,2,162,0,123,3,41,5,85,2,112,0,92,5,52,3,15,5,25,2,44,5,71,0,23,5,52,3,46,3,46,5,72,2,20,0,13,5,76,5,48,5,48,2,32,2,32,3,1,3,73,3,73,5,29,0,39,3,29,3,29,3,29,4,29,4,29,4,29,3,29,3,29,3,65,1,40,1,36,2,31,0,74,5,68,3,54,2,129,3,54,5,25,2,44,5,44,0,18,5,52,3,15,3,15,5,67,3,67,3,67,2,71,0,23,5,76,5,48,3,73,2,51,0,26,3,34,4,73,5,42,4,2,2,114,2,50,5,50,3,43,4,43,3,29,3,29,3,29,3,65,5,65,3,65,0,22,1,21,2,0,0,38,5,6,3,54,2,75,3,54,2,19,3,15,5,67,2,71,0,23,5,52,3,15,5,67,3,67,3,67,3,72,2,20,0,13,5,52,5,35,3,73,3,34,0,56,0,56,4,56,2,9,5,51,3,73,3,73,5,70,2,69,4,43,4,86,5,86,4,43,5,43,4,43,3,29,3,12,2,10,2,27,0,38,5,68,3,54,2,129,3,54,2,19,3,15,5,67,2,71,5,71,5,71,5,71,5,20,0,13,5,76,3,46,5,72,2,20,0,13,5,76,5,152,5,152,2,189,3,181,0,35,2,32,5,50,3,69,3,143,0,187,3,143,3,197,2,86,3,143,3,143,0,182,3,197,5,197,5,197,4,194,2,157,3,160,2,61,5,61,5,63,0,55,5,6,3,196,3,147,3,147,3,147,5,172,3,172,3,172,2,71,5,71,5,20,0,13,5,76,3,163,5,183,4,183,3,183,3,183,3,183,2,20,0,13,5,76,5,26,3,144,0,168,4,168,5,180,4,180,4,180,4,180,4,193,3,191,5,178,0,180,5,168,5,180,5,168,5,180,5,164,3,198,5,197,2,161,1,36,0,155,2,81,0,38,5,6,3,196,5,158,2,44,0,18,5,45,3,147,5,172,3,172,3,172,2,71,0,13,5,76,5,48,3,151,5,143,2,43,4,69,2,28,3,69,5,43,4,86,5,86,3,197,0,182,4,182,3,197,5,197,5,197,2,149,3,197,3,197,2,161,1,21,2,0,0,38,5,6,3,196,2,19,0,52,3,147,5,172,2,71,0,23,5,52,3,147,3,147,5,172,2,71,0,13,5,76,5,48,5,26,3,144,4,151,0,168,0,184,0,184,4,168,4,168,4,168,5,180,4,180,3,178,3,191,4,178,3,169,0,179,5,164,3,198,3,146,0,188,1,153,4,153,1,153,1,153,2,167,0,195,3,154,5,177,2,63,0,55,5,159,3,196,5,158,2,44,5,44,0,18,5,45,3,196,5,172,2,71,5,71,5,71,5,71,5,71,5,20,0,13,5,76,5,26,3,144,4,144,4,144,0,184,4,168,4,184,3,151,3,151,0,184,5,180,4,180,5,168,5,180,3,178,3,178,5,178,3,178,5,169,3,165,1,175,4,175,2,192,0,192,0,192,0,192,0,145,0,174,5,176,5,142,3,156,3,156,5,156,5,171,0,166,3,171,0,166,3,171,0,166,3,171,0,166,3,171,0,166,5,148,3,173,5,190,2,112,0,92,5,52,3,147,5,172,5,172,2,71,5,71,0,23,5,52,3,147,5,172,2,71,5,20,0,13,5,76,5,35,5,35,3,150,3,150,3,150,0,185,5,193,0,180,0,180,4,180,5,168,5,180,4,180,4,180,4,180,4,180,3,169,4,169,0,179,3,165,2,186,0,186,5,170
58,2,119,0,123,3,41,5,85,2,112,0,92,5,52,3,54,2,19,3,15,5,67,2,71,5,71,5,71,5,71,0,23,5,52,3,15,5,67,3,67,2,71,5,71,5,71,5,20,0,13,5,76,5,26,3,34,4,73,0,56,4,56,3,73,3,73,4,47,3,47,0,80,5,80,5,80,3,47,5,42,5,42,3,42,3,42,3,70,3,29,3,12,1,21,2,0,0,74,5,68,3,54,3,54,5,25,2,5,5,5,0,57,5,6,3,54,5,25,5,25,5,25,5,25,5,202,3,202,2,199,0,200,2,71,0,23,5,52,5,48,5,48,4,26,4,26,3,34,0,56,4,56,4,56,5,56,3,73,4,73,0,17,5,17,5,17,4,56,3,73,5,29,3,65,1,40,5,36,2,31,0,74,5,68,3,54,3,54,2,19,3,15,5,67,3,67,2,71,0,23,5,52,3,15,3,15,5,67,2,71,0,23,5,76,5,48,2,32,3,1,0,26,3,34,0,56,4,56,4,56,3,34,5,29,4,29,0,39,3,29,4,65,5,65,5,65,0,16,3,65,4,65,3,12,1,21,2,0,0,74,5,68,3,54,5,25,3,25,2,5,0,57,5,6,3,54,5,67,2,71,0,23,5,76,5,48,5,48,5,48,3,73,5,29,4,29,3,29,3,29,5,29,5,29,5,29,4,65,3,65,5,65,3,65,3,65,5,65,0,16,3,65,0,22,1,36,2,90,2,120,3,0,0,38,5,6,3,54,2,129,3,54,5,25,0,201,3,67,2,71,0,23,5,52,3,15,5,67,3,67,2,71,5,71,0,13,5,76,5,26,3,34,4,34,0,56,4,56,4,56,4,56,5,56,4,56,5,56,4,56,4,56,5,56,5,56,5,56,3,34,5,65,5,65,1,40,2,90,2,120,3,0,0,38,5,6,3,54,5,25,2,44,5,71,5,71,5,71,0,23,5,52,3,46,5,72,3,72,2,20,0,13,5,76,5,26,3,34,4,73,0,56,4,56,4,56,4,56,4,17,3,73,5,29,5,29,5,29,5,29,3,29,3,29,4,29,4,29,3,65,4,65,4,12,2,10,2,27,0,3,5,68,3,4,5,30,2,62,0,57,5,6,3,54,5,25,2,71,0,23,5,76,5,48,5,48,5,48,4,48,4,26,5,48,5,35,3,73,3,73,5,70,0,39,3,70,4,70,5,70,5,29,4,29,3,65,5,65,5,65,4,12,1,21,2,0,0,74,5,68,3,4,5,25,5,25,5,25,2,5,0,57,5,45,3,15,5,67,3,67,2,71,5,20,0,13,5,76,5,26,3,34,0,56,4,56,4,17,2,51,3,73,3,73,3,73,0,17,4,17,5,17,5,17,2,1,3,73,5,70,4,29,4,29,3,65,3,12,1,21,2,0,0,38,5,68,3,4,5,25,2,5,0,57,5,6,3,54,2,129,3,54,5,67,2,71,0,13,5,76,5,48,3,73,3,73,3,73,2,51,0,60,5,60,3,34,0,17,0,56,3,34,3,34,3,34,5,29,3,29,3,65,3,65,5,65,3,65,0,22,1,21,2,0,0,0,0,38,5,6,3,54,5,25,2,44,5,44,5,71,0,23,5,52,3,46,3,46,3,46,2,97,3,46,3,46,3,46,5,72,2,20,0,13,5,76,5,35,0,7,4,35,3,47,3,47,0,53,4,53,0,80,5,80,3,47,5,70,2,43,4,69,5,43,4,86,4,43,5,43,4,43,3,29,5,12,1,21,2,0,0,38,5,6,3,54,5,25,0,200
58,4,83,3,83,3,83,3,83,3,83,5,83,3,83,3,83,3,83,5,83,5,83,0,66,3,41,2,162,0,123,3,41,5,85,2,112,0,92,5,52,3,46,5,72,2,20,5,20,0,13,5,76,3,46,5,72,2,20,0,13,5,76,5,26,3,34,2,51,3,34,0,56,0,56,4,56,4,56,4,56,5,56,5,56,5,56,5,56,3,34,5,70,0,39,3,29,3,65,4,65,0,22,2,10,2,81,0,38,5,6,3,54,2,129,3,54,5,67,2,71,5,71,0,23,5,52,3,15,5,67,2,71,5,71,5,20,5,20,0,13,5,76,5,26,2,32,3,51,0,48,0,48,4,48,5,48,2,32,4,32,4,211,3,9,3,34,5,29,4,29,5,29,3,29,3,29,5,29,5,65,0,22,1,21,2,0,0,74,5,68,3,54,5,25,2,5,0,57,5,6,5,203,3,8,3,8,0,53,0,53,4,53,4,53,3,8,4,8,0,80,4,80,5,80,4,80,4,80,2,79,3,47,5,42,3,42,5,42,2,204,5,214,0,207,3,12,1,21,2,0,0,0,0,0,0,74,5,68,3,54,5,25,2,44,5,44,5,44,0,18,5,45,3,54,5,67,2,44,5,71,0,23,5,52,5,35,5,35,0,35,0,35,2,32,4,32,3,1,4,1,3,73,3,73,0,17,5,56,3,34,3,34,5,29,3,29,3,65,4,65,3,65,1,36,2,31,0,74,5,68,3,54,3,54,2,129,3,54,2,75,3,15,3,15,5,67,4,67,3,67,3,67,3,67,5,67,2,71,0,23,5,52,3,46,3,46,3,46,3,46,5,72,2,20,0,13,5,76,5,26,3,34,0,17,5,56,5,56,4,56,4,56,4,17,3,34,0,56,5,56,3,34,5,29,5,29,3,29,3,29,0,39,3,65,3,65,2,22,1,21,2,213,0,10,2,61,5,63,0,55,5,159,3,54,2,129,3,54,2,19,3,15,5,67,3,67,3,67,3,67,3,67,3,67,2,20,0,13,5,76,3,99,5,72,2,71,0,23,5,45,5,7,3,8,4,8,4,8,0,53,0,53,4,53,3,8,4,8,3,8,3,8,2,79,3,47,4,47,5,42,4,70,5,29,3,65,4,65,4,12,1,21,2,0,0,74,3,101,5,101,5,101,3,101,2,63,0,55,5,6,3,54,2,75,3,54,5,25,0,201,2,71,5,71,5,20,0,13,5,49,3,99,5,72,3,209,5,209,0,210,3,72,2,20,5,20,5,20,0,13,5,76,5,48,5,26,4,26,3,34,0,56,4,56,3,34,0,56,4,56,5,56,5,56,3,34,4,34,5,29,3,65,5,65,5,65,5,65,3,65,4,12,1,21,2,0,0,74,5,68,3,54,2,129,3,54,2,75,3,54,5,25,2,44,5,44,0,18,5,52,3,46,5,67,3,25,5,25,2,71,5,71,5,71,0,23,5,52,5,35,5,35,4,35,0,48,3,34,4,34,4,34,5,29,3,29,2,86,4,43,4,86,4,86,5,43,5,43,5,43,4,43,0,212,5,212,3,12,2,10,3,101,2,109,2,61,5,61,0,74,5,33,3,4,3,4,2,206,3,215,3,4,5,30,2,5,0,57,5,6,3,54,5,67,1,201,2,71,5,20,0,13,5,76,5,48,5,48,3,73,4,34,0,17,5,56,4,17,0,17,5,56,5,56,4,56,5,56,5,56,5,17,3,34,5,65,0,16,5,108,3,108,3,93,3,93,3,82,2,208,0,205,3,41,2,162,3,41,2,162
58,3,83,0,66,2,162,0,123,3,41,5,14,2,112,0,92,5,52,3,46,5,72,3,72,2,20,0,13,5,76,3,46,5,72,2,20,5,20,5,77,5,20,0,103,5,49,5,60,3,34,0,56,4,56,0,56,4,56,4,56,4,17,0,17,4,17,5,56,3,34,5,29,3,29,3,29,3,29,3,29,4,29,3,29,2,95,1,36,2,31,0,74,5,68,3,54,5,25,2,44,0,18,5,45,3,54,5,67,2,71,5,71,0,23,5,76,5,48,4,48,2,32,4,211,4,211,4,211,4,32,4,211,2,211,4,211,5,105,5,105,4,105,3,86,4,43,5,43,0,212,5,212,3,29,3,12,2,10,2,81,0,38,5,68,3,54,3,54,2,129,3,54,2,19,0,52,3,15,5,67,3,67,5,67,2,71,0,13,5,76,3,46,5,72,3,72,3,72,3,72,2,20,5,77,5,20,0,13,5,76,5,35,3,47,5,42,4,42,4,2,0,78,4,111,2,114,2,50,3,43,4,86,3,29,3,29,4,29,0,39,3,65,3,65,3,65,3,65,0,22,1,21,2,0,5,0,0,38,5,6,3,54,3,15,5,67,2,71,5,71,0,23,5,52,3,15,5,72,2,20,0,13,5,76,5,26,2,32,3,51,3,73,5,70,2,43,2,50,3,69,4,43,4,86,4,127,0,124,2,127,4,127,4,127,0,217,5,212,3,65,5,65,5,12,2,10,2,27,0,38,5,68,3,4,5,30,2,5,0,57,5,6,3,54,5,25,5,25,5,25,5,25,5,25,5,25,5,25,2,5,0,18,5,45,5,7,3,8,3,8,5,2,2,11,4,114,3,42,2,11,4,114,2,28,3,114,3,42,0,78,5,73,4,73,4,73,5,24,2,69,5,43,3,137,3,12,2,10,2,27,0,38,5,68,3,4,5,25,5,25,2,5,0,57,5,45,3,54,2,19,3,15,5,67,3,67,2,71,5,20,0,13,5,76,5,26,3,34,2,9,3,34,4,34,5,29,4,29,0,39,4,16,4,16,4,16,2,127,2,127,2,127,4,127,3,65,5,65,3,65,5,65,0,22,1,21,2,0,0,38,5,6,3,54,2,75,3,54,5,67,2,71,5,71,0,23,5,52,3,46,3,46,3,46,3,46,5,72,3,72,3,72,5,72,2,20,0,13,5,76,5,26,3,34,5,29,0,24,4,24,0,39,4,39,3,70,4,29,0,39,4,39,3,29,4,29,3,65,0,16,5,108,5,16,5,108,3,108,2,218,4,216,2,208,0,205,3,89,5,14,2,63,0,55,5,6,3,54,5,25,2,44,0,23,5,52,3,15,5,67,2,20,0,13,5,76,5,35,5,48,3,73,5,70,5,29,0,29,4,29,4,29,4,29,3,29,0,70,4,42,4,42,4,70,4,70,4,70,3,70,5,29,1,40,2,90,2,120,3,0,5,0,0,38,5,6,3,54,5,25,2,44,5,44,5,44,5,71,0,23,5,52,3,15,5,67,3,67,2,71,0,23,5,52,5,48,5,48,0,48,4,48,5,26,5,48,4,26,3,34,0,73,3,73,4,34,4,34,5,29,4,29,3,29,3,29,5,29,5,65,5,65,0,12,1,21,2,0,0,74,5,68,3,54,5,25,5,25,2,5,0,57,5,45,3,15,5,67,3,67,2,71,5,20,0,13,5,76,5,48,0,48,0,48,3,73,2,1,4,1,0,48,3,34,0,34,5,39,4,39,3,29,5,29,5,29,2,43,5,43,5,43,3,29,5,65,3,12,2,10
58,4,83,3,83,0,66,5,66,3,41,2,162,0,123,3,41,5,85,2,112,0,92,5,52,3,15,3,15,5,67,3,67,3,25,2,44,5,71,0,23,5,52,3,15,5,67,2,71,0,13,5,76,5,26,3,34,0,17,5,56,5,17,3,73,3,34,0,56,5,56,4,56,5,56,3,34,5,65,4,29,3,29,3,29,3,65,5,65,5,65,0,22,1,21,2,0,0,74,5,68,3,54,2,129,3,54,5,25,2,5,0,57,5,45,3,15,5,67,2,71,0,23,5,52,5,35,5,48,4,48,4,48,5,26,4,26,3,73,3,34,0,56,5,56,5,56,3,34,0,56,4,56,3,34,5,70,4,29,3,65,1,40,5,36,2,31,0,74,5,68,3,54,2,129,3,54,2,75,3,54,2,75,3,54,2,19,3,15,5,67,4,67,2,71,0,23,5,52,3,15,5,67,2,71,0,13,5,76,5,26,3,34,4,73,2,51,4,1,3,73,5,70,4,70,0,39,3,29,5,70,4,29,3,29,0,24,3,70,4,29,3,65,4,65,1,235,2,90,5,90,2,120,3,0,0,38,5,6,3,54,5,25,5,25,5,25,2,5,0,57,5,45,3,15,3,15,5,67,2,71,5,20,0,103,5,76,5,48,2,32,3,1,4,1,0,26,2,32,0,131,3,1,3,34,0,56,5,56,5,56,5,56,5,56,3,34,5,29,3,65,5,65,4,65,4,12,2,10,2,81,0,74,5,68,3,54,2,129,3,54,3,15,5,67,2,71,0,23,5,52,3,15,5,67,3,67,3,67,2,71,0,23,5,76,5,26,3,73,5,29,4,29,4,70,2,43,2,50,0,227,3,43,0,217,4,124,4,124,2,127,4,127,4,86,5,43,0,212,5,212,3,65,2,22,1,21,2,0,0,0,0,38,5,6,3,54,2,75,3,54,5,25,2,44,5,44,5,44,5,44,5,44,5,44,5,44,0,18,5,52,3,15,5,72,3,72,3,72,2,20,0,103,5,49,5,26,4,26,3,34,4,34,4,34,0,56,4,56,3,34,0,17,3,73,5,70,4,29,3,70,4,29,3,29,5,29,3,65,5,65,3,65,0,22,1,21,2,0,0,38,5,6,3,54,3,54,2,129,3,54,2,75,0,45,3,54,5,25,2,44,5,44,5,44,0,23,5,52,3,15,3,15,5,67,2,71,0,23,5,76,5,48,3,73,3,34,4,34,4,34,4,34,4,108,4,108,0,113,4,113,4,113,4,113,4,113,2,130,5,130,3,108,5,65,5,65,4,65,0,22,1,21,2,0,0,0,0,74,5,68,3,54,3,54,5,25,2,5,0,57,5,6,3,54,2,129,3,54,5,25,2,71,0,23,5,52,5,7,3,8,0,53,2,37,3,8,4,8,0,53,5,53,4,80,4,80,4,80,3,73,5,70,2,69,5,43,3,29,4,29,3,29,3,29,3,12,2,10,2,81,0,38,5,33,3,4,5,25,5,25,2,5,0,57,5,6,3,54,3,15,5,67,3,67,2,71,0,23,5,52,5,35,4,48,5,48,3,34,4,34,0,53,5,53,5,53,2,226,0,219,3,47,2,237,0,230,3,34,5,70,4,29,3,65,3,65,3,65,3,12,1,21,2,220,0,236,5,229,3,54,5,25,2,234,0,225,5,222,3,54,5,67,2,224,0,232,5,231,5,233,2,228,2,228,3,221,3,8,5,2,5,2,2,111,4,111,5,111,5,78,3,42,5,70,4,29,3,70,4,70,2,223,3,29,4,65,0,22,1,21
